lemma	headword	definition	chapter
ab	ā ab abs	"from, by (+ abl.)"	
abeo	abeō -īre -iī -itum	go away	
absum	absum abesse āfuī	"be away, absent"	
accedo	accēdō -cēdere -cessī -cessum	approach	
accido	accidō -cidere -cidī	fall; happen	
accipio	accipiō -cipere -cēpī -ceptum	receive	
acer2	ācer ācris ācre	"sharp, piercing"	
acies	aciēs -ēī f.	edge; line of battle	
ad	ad	"to, up to, towards (+ acc.)"	
addo	addō -dere -didī -ditum	give to	
adduco	addūcō -ere -dūxī -ductum	"lead to, induce"	
adeo	adeō -īre -iī -itum	go to	
adeo2	adeō	"(adv.) to such a degree, so"	
adhibeo	adhibeō -hibēre -hibuī -hibitum	apply	
adhuc	adhūc	"thus far, to this point"	
adsum	adsum adesse affuī	be present	
advenio	adveniō -īre -vēnī -ventum	"come to, arrive at"	
adversum	adversum	"(adv. and prep.) facing, opposite, against, opposed (to)"	
adversus	adversus -a -um	"facing, opposed; unfavorable"	
adversus3	adversus	"(adv. and prep.) facing, opposite, against, opposed (to)"	
adverto	advertō -vertere -vertī -versum	turn towards	
aedes	aedēs -is f.	building; (pl.) house	
aeger	aeger aegra aegrum	sick	
aegre	aegrē	with difficulty	
aeque	aequē	equally	
aequor	aequor aequoris n.	"level surface, sea, plain"	
aequus	aequus -a -um	equal	
aer	āēr āeris m.	air	
aes	aes aeris n.	"copper, bronze"	
aetas	aetās -tātis f.	"age, time of life"	
aeternus	aeternus -a -um	"everlasting, eternal"	
aether	aethēr aetheris n.	"pure upper air, ether, heaven, sky"	
aevum	aevum -i n.	"eternity; lifetime, age"	
affero	afferō afferre attulī allātum	bring to	
afficio	afficiō -ficere -fēcī -fectum	"affect, visit with (+ abl.)"	
ager	ager agrī m.	field	
agito	agitō -āre	drive	
ago	agō agere ēgī āctum	"drive, do, act"	
aio	aiō	"say, affirm, say yes; ut āiunt: as they say"	
albus	albus -a -um	white	
alienus	aliēnus -a -um	"foreign, strange"	
aliquando	aliquandō	"at some time, at length"	
aliquis	aliquis -quae -quod	"some, any; si quis, si quid: anyone who, anything that"	
aliter	aliter	"otherwise, differently"	
alius	alius -a -ud	"other, another; ālias: at another time"	
alo	alō alere aluī alitum	nourish	
alter	alter altera alterum	other of two	
agmen	āgmen -minis n.	line of march	
altus	altus -a -um	"high, lofty; deep"	
amica	amīca -i f.	friend	
amicitia	amīcitia -ae f.	friendship	
amicus	amīcus -a -um	friendly	
amicus2	amīcus -i m.	friend	
amitto	āmittō -mittere -mīsī -missum	"let go, send away"	
amnis	amnis -is m.	"river, torrent"	
amo	amō -āre	to love; amāns -ntis m./f.: lover	
amor	amor -ōris m.	love	
amplus	amplus -a -um	"large, spacious"	
an	an	or (in questions); utrum ... an: whether ... or	
anima	anima -ae f.	"breath, spirit"	
animal	animal -ālis n.	"a living being, an animal"	
animus	animus -ī m.	"spirit, mind"	
annus 	annus -ī m.	year	
ante	ante	"before, in front of (adv. and prep. + acc.)"	
antequam	antequam	before	
antiquus	antīquus -a -um	"ancient, old-time, former"	
aperio	aperiō aperīre aperuī apertum	open	
appareo 	appāreō -ēre -uī	"appear, become visible"	
appello2	appellō -pellāre	"call, address, name"	
aptus	aptus -a -um	"fit, suitable"	
apud 	apud	"near, in the presence of (+ acc.)"	
aqua	aqua -ae f.	water	
ara	āra -ae f.	altar	
arbitror	arbitror arbitrārī arbitrātus sum	"consider, think"	
arbor	arbor arboris f.	tree	
ardeo	ārdeō ārdēre ārsī ārsum	"blaze, glow; be eager"	
argentum 	argentum -ī n.	"silver, money"	
arma	arma -ōrum n. pl.	"arms, weapons"	
ars 	ars artis f.	skill	
arvum	arvum -ī n.	"ploughed land, field"	
arx 	arx arcis f.	"citadel, castle; summit"	
ascendo	ascendō -ere -scendī -scēnsum	"climb up, ascend"	
aspicio	aspiciō -ere -spēxī -spectum	"look to or at, behold"	
astrum	astrum -ī n.	star; constellation	
at	at	"but, but yet"	
atque	ac	"and in addition, and also, and; (after comparatives) than; simul ac, as soon as; → atque"	
atque	atque	"and in addition, and also, and; (after comparatives) than; simul atque, as soon as; → ac"	
auctor	auctor -ōris m.	"originator, founder"	
auctoritas	auctōritās -ātis f.	"influence, clout, authority"	
audax	audāx audācis	"bold, daring; reckless"	
audeo	audeō audēre ausus sum	"dare, be eager"	
audio	audiō -īre -īvī/-iī -ītum	"hear, listen to"	
aufero	auferō auferre abstulī ablātum	take away	
augeo	augeō augēre auxī auctum	increase	
aura	aura -ae f.	breeze	
aureus	aureus -a -um	golden; splendid	
auris	auris -is f.	ear	
aurum	aurum -ī n.	gold	
aut	aut	or	
autem	autem	"moreover, but, however"	
auxilium	auxilium -ī n.	"support, assistance; (pl.) auxiliary forces"	
avis	avis -is f.	bird	
barbarus	barbarus -ī m.	"foreigner, barbarian"	
beatus	beātus -a -um	"happy, blessed, prosperous, fortunate"	
bellum	bellum -ī n.	war	
bene	bene	well	
beneficium	beneficium -ī n.	"service, kindness"	
bonus	bonus -a -um	good	
bos	bōs bovis m.	ox; gen. pl. boum	
brevis	brevis -e	"short, shallow, brief"	
breviter	breviter	briefly	
cado	cadō cadere cecidī cāsum	"fall, be killed"	
caecus	caecus -a -um	"blind, unseeing; dark, obscure"	
caedes	caedēs -is f.	"killing, slaughter"	
caedo	caedō caedere cecīdī caesum	"strike, kill, cut down"	
caelestis	caelestis -e	"from or of heaven; caelestēs, the gods"	
caelum2	caelum -ī n.	"sky, heavens"	
campus	campus -ī m.	"plain, field"	
candidus	candidus -a -um	"white, fair"	
canis	canis -is m./f.	dog	
cano	canō canere cecinī cantum	sing	
capio	capiō capere cēpī captum	seize	
caput	caput capitis n.	head	
careo	careō -ēre -uī	lack (+ abl.)	
carmen	carmen -inis n.	song	
carus	cārus -a -um	dear	
castrum	castrum -ī n.	"fortress, (regularly plural, castra camp)"	
castus	castus -a -um	"pure, spotless, chaste"	
casus	cāsus -ūs m.	"a fall; chance, accident"	
causa	causa -ae f.	"cause, reason; causā + preceding genitive, for the sake of"	
caveo	caveō cavēre cāvī cautum	"be on guard, beware"	
cedo	cēdō cēdere cessī cessum	"go, move; yield"	
celebro	celebrō -āre	"frequent, throng, crowd"	
celer	celer -is -e	swift	
celeriter	celeriter	quickly	
censeo	cēnseō cēnsēre cēnsuī cēnsum	"assess, rate; think, decide"	
centum	centum	one hundred	
cerno	cernō cernere crēvī crētum	"discern, separate"	
certe	certē	"certainly, surely"	
certo2	certō -āre	"decide by contest; fight, compete, vie"	
certus	certus -a -um	"sure, fixed"	
ceterum2	cēterum	"for the rest, in addition, however that may be"	
ceterus	cēterus -a -um	"the other, the others, the rest"	
cibus	cibus -ī m.	food	
cingo	cingō cingere cīnxī cīnctum	"encircle, surround, gird"	
cinis	cinis cineris m./f.	"ashes, embers"	
circa	circā	around (adv. and prep. + acc.)	
cito	citō	swiftly	
citus	citus -a -um	swift	
civis	cīvis -is m./f.	citizen	
civitas	cīvitās -ātis f.	"citizenship, state"	
clamor	clāmor -ōris m.	"outcry, shout"	
clarus	clārus -a -um	"clear, distinguished"	
classis	classis -is f.	"class, division, fleet"	
claudo	claudō claudere clausī clausum	"close, shut"	
coepi	coepī coepisse coeptus	begin	
cogito	cōgitō -āre	"think, reflect"	
cognosco	cōgnōscō -gnōscere -gnōvī -gnitum	"learn, understand"	
cogo	cōgō cōgere coēgī coāctum	drive together; compel	
cohors	cohors cohortis f.	"cohort, band, troop"	
colligo	colligō -ere -lēgī -lēctum	"gather together, collect"	
colo	colō colere coluī cultum	"inhabit, cultivate"	
color	color -ōris m.	color	
coma	coma -ae f.	"hair, tresses"	
comes	comes comitis m./f.	"companion, comrade; attendant, follower"	
committo	committō -mittere -mīsī -missum	"join, entrust to (+ dat.); perform, do"	
communis	commūnis -e	"common, general"	
comparo	comparō -āre	"get ready, provide; compare"	
compono	compōnō -pōnere posuī positum	"build, construct, arrange"	
concedo	concēdō -cēdere -cessī -cessum	"yield, withdraw"	
condicio	condīciō -ōnis f.	"agreement, condition"	
condo	condō -dere -didī -ditum	"build, found; store up; hide, conceal"	
confero	cōnferō cōnferre contulī collātum	"collect, bring to"	
conficio	cōnficiō -ficere -fēcī -fectum	"complete, accomplish; destroy, kill, consume"	
confiteor	cōnfiteor cōnfitērī cōnfessus sum	"admit (a fact), confess (a crime); reveal, disclose"	
coniunx	coniunx coniugis m./f.	"spouse, husband, wife"	
conor	cōnor cōnārī cōnātus sum	"try, attempt"	
consequor	cōnsequor -sequī -secūtus sum	"follow up, overtake, attain"	
consilium	cōnsilium -ī n.	"plan; council, group of advisors"	
consisto	cōnsistō -sistere -stitī	"take position; consist in, be composed of"	
constituo	cōnstituō -stituere -stituī -stitūtum	"establish, put together"	
consto	cōnstō -stāre -stitī	"agree; constat, it is established that (+ acc. and infin.)"	
consuetudo	cōnsuētūdo -inis f.	"custom, habit"	
consul	cōnsul -ulis m.	consul	
consulo	cōnsulō -sulere -suluī -sultum	"consult, plan (+ acc.); consider the interests of (+ dat.)"	
consumo	cōnsūmō -sūmere -sūmpsī -sūmptum	"to use up, consume"	
contemno	contemnō -temnere -tempsī -temptum	"despise, scorn, disdain"	
contineo	contineō -tinēre -tinuī -tentum	"contain, restrain"	
contingo	contingō -tingere -tigī -tactum	"touch, be contiguous to"	
contra	contrā	"against, opposite (adv. and prep. + acc.)"	
convenio	conveniō -venīre -vēnī -ventum	"assemble, meet; agree"	
converto	convertō -vertere -vertī -versum	"turn about, turn, change"	
convivium	convīvium -iī n.	"banquet, feast"	
copia	cōpia -ae f.	abundance; (pl.) troops	
copia	cor cordis n.	"heart; cordī est, it is pleasing to (+ dat.)"	
cor	cornu -ūs n.	horn	
corpus	corpus corporis n.	body	
corrumpo	corrumpō -rumpere -rūpī -ruptum	"break up, destroy, ruin"	
credo	crēdō crēdere crēdidī crēditum	believe	
creo	creō -āre	"produce, create; elect, choose"	
cresco	crēscō crēscere crēvī crētum	"grow, increase"	
crimen	crīmen -inis n.	"verdict, accusation"	
culpa	culpa -ae f.	"guilt, fault, blame"	
cum	cum	with (prep. + abl.)	
cum2	cum	"when, since, although (conjunction + subj.)"	
cunctus	cūnctus -a -um	entire all together	
cupido	cupīdō -inis f.	"desire, eagerness, craving"	
cupio	cupiō -ere -īvī -ītum	desire	
cur 	cūr	why?	
cura	cūra -ae f.	"care, concern"	
curo	cūrō -āre	"watch over, look after, care for (+ acc.)"	
curro	currō currere cucurrī cursum	run	
currus	currus -ūs m.	chariot	
cursus	cursus -ūs m.	"course, advance"	
custos	custōs custōdis m.	guardian	
damno	damnō -āre	condemn	
damnum	damnum -ī n.	"damage, injury"	
de2	dē	"down from, about, concerning (+ abl.)"	
dea	dea -ae f.	goddess	
debeo	dēbeō dēbēre dēbuī dēbitum	"owe, be obliged"	
decem	decem	ten	
decerno	dēcernō -cernere -crēvī -crētum	"determine, decide"	
decet	decet decēre decuīt	"it is right, proper, fitting (+ acc. + infin.)"	
decus	decus decoris n.	"beauty, grace; ornament, glory, honor"	
deduco	dēdūcō -dūcere -dūxī -ductum	"launch, lead away"	
defendo	dēfendō -fendere -fendī -fēnsum	"defend, ward off"	
defero	dēferō -ferre -tulī -lātum	"carry away, report"	
deficio	deficiō -ficere -fēcī -fectum	"fail, give out; revolt from"	
deinde 	deinde or dein	"then, next"	
denique	dēnique	finally	
descendo	dēscendō -scendere -scendī -scēnsum	"climb down, descend"	
desero2	dēserō -ere dēseruī dēsertum	"leave, desert, abandon"	
desidero	dēsīderō -āre	"long for, desire greatly"	
desino	dēsinō -sinere -siī -situm	"leave off, cease"	
desum	dēsum -esse -fuī	be lacking	
deus	deus -ī m.	god	
dexter	dexter -tra -trum	right	
dextera	dextera -ae f.	right hand	
dico2	dīcō dīcere dīxī dictum	"say; causam dīcere, plead a case; diem dīcere, appoint a day"	
dies 	diēs diēī m./f.	day	
differo	differō differre distulī dīlātum	"scatter; publish, divulge; differ; defer, postpone"	
difficilis	difficilis -e	"not easy, hard, difficult"	
dignitas	dīgnitās -ātis f.	"worth, reputation, honor"	
dignus	dīgnus -a -um	worthy	
diligo	dīligō -ligere -lēxī -lēctum	"choose, cherish, love"	
dimitto	dīmittō -mittere -mīsī -missum	send away	
discedo	discēdō -ere -cessī -cessum	"go away, depart"	
disciplina	disciplīna -ae f.	"training, instruction; learning, discipline"	
disco	discō -ere didicī	learn	
diu	diū	for a long time	
diversus	dīversus -a -um	"different, diverse"	
dives	dīves dīvitis	"rich (poet. dīs, dītis)"	
divido	dīvidō -ere dīvīsī dīvīsum	"divide, separate"	
divitiae	dīvitiae -ārum f. pl.	"riches, wealth"	
divus	dīvus -a -um	"divine, godlike"	
divus2	dīvus dīvī m.	god	
do	dō dare dedī datum	give	
doceo	doceō -ēre -uī doctum	teach	
doleo	doleō -ēre doluī	"feel pain or grief, grieve"	
dolor	dolor -ōris m.	"pain, grief"	
dolus	dolus -ī m.	"artifice, device, trick"	
domina	domina -ae f.	"household mistress, lady"	
dominus	dominus -ī m.	"household master, lord"	
domus	domus -ūs f.	"house, home"	
donec	dōnec	until	
dono	dōnō -āre	present with a gift (+ acc. of person and abl. of thing)	
donum	dōnum -ī n.	"gift, present"	
dormio	dormiō -īre	sleep	
dubito	dubitō -āre	"hesitate, doubt"	
dubius	dubius -a -um	"doubtful; (as subst.) a doubt; sine dubiō, without a doubt, certainly"	
duco 	dūcō dūcere dūxī ductum	"lead; uxōrem dūcere, marry"	
dulcis	dulcis -e	sweet	
dum	dum	while (+ indic.); until (+ subj.); provided that (+ subj.)	
dum	duo duae duo	two	
duo 	dūrus -a -um	"hard, tough, harsh"	
durus	dux ducis m./f.	"leader, general"	
dux	ecce	behold!	
ecce	ēdīcō -dīcere -dīxī -dictum	declare	
edo2	ēdō ēdere ēdidī ēditum	"put forth, state, explain"	
educo	ēdūcō -dūcere -dūxī -ductum	lead forth	
efficio 	efficiō -ficere -fēcī -fectum	"bring about, complete; render (+ ut + subj.)"	
effundo	effundō -fundere -fūdī -fūsum	pour out	
ego	ego meī mihi mē	"I, me"	
egredior	ēgredior ēgredī ēgressus sum	"stride out, depart, disembark from (+ abl.)"	
egregius	ēgregius -a -um	"distinguished, uncommon"	
eligo	ēligō ēligere ēlēgī ēlēctum	"pick out, select"	
enim	enim	"for, indeed"	
eo	eō īre iī/īvī itum	go	
eo2	eō	"(adv.) there, to that place"	
epistula	epistula -ae f.	letter	
eques	eques equitis m.	"horseman, knight"	
equus	equus -ī m.	horse	
ergo	ergō	therefore	
eripio	ēripiō -ripere -ripuī -reptum	"snatch away, rescue, save"	
erro	errō -āre	"go astray, wander"	
error	error -ōris m.	"wandering; error, mistake"	
et	et	and	
etiam	etiam	"also, even"	
ex	"ex, ē"	"out of, from (+ abl.)"	
excipio	excipiō -cipere -cēpī -ceptum	take out	
exemplum	exemplum -ī n.	"example, sample, copy"	
exeo	exeō -īre -iī -itum	go forth	
exerceo	exerceō -ercēre -ercuī -ercitum	"train, exercise, carry on"	
exercitus2	exercitus -ūs m.	army	
exigo	exigō -igere -ēgī -āctum	drive out; collect	
existimo	exīstimō -āre	"think, believe"	
experior	experior -perīrī -pertus sum	"try thoroughly, test, experience"	
exsilium	exsilium -ī n.	"exile, banishment"	
exspecto	exspectō -āre	"watch, wait, expect"	
extremus	extrēmus -a -um	"farthest, situated at the end or tip, extreme"	
fabula	fābula -ae f.	"account, tale, story"	
facies	faciēs -ēī f.	"form, appearance"	
facilis	facilis -e	easy	
facinus	facinus facinoris n.	"deed, crime"	
facio	faciō facere fēcī factum	"do, make"	
factum	factum -ī n.	"deed, accomplishment"	
fallo	fallō fallere fefellī falsum	deceive	
falsus	falsus -a -um	"deceptive, false"	
fama	fāma -ae f.	"rumor, fame"	
fames	famēs -is f.	"hunger, famine"	
familia	familia -ae f.	"household, family"	
fateor	fateor fatērī fassus sum	"admit, confess; profess, declare; assent, say yes"	
fatum	fātum -ī n.	fate; death	
fax	fax facis f.	torch	
feliciter	fēlīciter	luckily	
felix	fēlīx -īcis	lucky	
femina	fēmina -ae f.	woman	
fera	fera -ae f.	wild animal	
fere	ferē	almost	
fero	ferō ferre tulī lātum	"bear, carry, endure"	
ferrum	ferrum -ī n.	"iron, iron weapon or implement"	
ferus	ferus -a -um	"wild, fierce"	
fessus	fessus -a -um	"weary, tired"	
fidelis	fidēlis -e	faithful	
fides	fidēs -eī f.	"trust, faith"	
filia	fīlia -ae f.	daughter	
filius	fīlius -ī m.	son	
fingo	fingō fingere fīnxī fīctum	shape; invent	
finis	fīnis -is m.	"end, boundary"	
fio	fīō fierī factus sum	"become, happen, be done"	
flamma	flamma -ae f.	"flame, fire"	
fleo	fleō flēre flēvī flētum	weep	
flos	flōs flōris m.	"flower, bloom"	
fluctus	fluctus -ūs m	"flood, billow, surf"	
flumen	flūmen -inis n.	"stream, river"	
fluo	fluō fluere fluxī fluxum	flow	
foedus	foedus -a -um	foul	
fons	fōns fontis m.	"spring, fountain"	
for	for fārī fātus sum	"report, say"	
forma	fōrma -ae f.	shape; beauty	
fors	fors fortis f.	chance	
forsitan	forsitan	"perhaps, perchance"	
fortasse	fortasse	"perhaps, perchance"	
forte	forte	by chance	
fortis	fortis -e	brave	
fortuna	fortūna -ae f.	fortune	
forum	forum -ī n.	"market-place, forum"	
frango	frangō frangere frēgī frāctum	"break, shatter"	
frater	frāter frātris m.	brother	
frequens	frequēns -ntis	"in large numbers, often"	
frons2	frōns frontis f.	"forehead, brow; front"	
fructus2	frūctus -ūs m.	"fruit, crops; enjoyment, delight"	
frumentum	frūmentum -ī n.	grain	
fruor	fruor fruī frūctus sum	"enjoy the produce of, profit by, use (+ abl.)"	
frustra	frūstrā	in vain	
fuga	fuga -ae f.	"flight, route"	
fugio	fugiō fugere fūgī fugitum	"flee, escape"	
fugo	fugō -āre	put to flight	
fundo	fundō fundere fūdī fūsum	"pour, scatter"	
funus	fūnus fūneris n.	funeral; death; dead body	
furor2	furor -ōris m.	"rage, fury"	
gaudeo	gaudeō gaudēre gāvīsus sum	rejoice	
gaudium	gaudium -ī n.	"delight, joy, pleasure"	
gens	gēns gentis f.	"family, clan"	
genus	genus generis n.	"origin, lineage, kind"	
gero	gerō gerere gessī gestum	"bear, manage; bellum gerere, wage war"	
gigno	gīgnō gīgnere genuī genitum	"beget, bear, bring forth"	
gladius	gladius -ī m.	sword	
gloria	glōria -ae f.	"glory, fame"	
gradus	gradus -ūs m.	"step, pace; grade, rank"	
gratia	grātia -ae f.	"favor, influence, gratitude"	
gratus	grātus -a -um	pleasant; grateful	
gravis	gravis -e	"heavy, serious"	
habeo	habeō habēre habuī habitum	"have, hold"	
haud	haud	not	
hic	hic haec hoc	"this, these"	
hic2	hīc	here	
hiems	hiems hiemis f.	winter	
hinc	hinc	from here	
hodie	hodiē	today	
homo	homō hominis m.	human being	
honestus	honestus -a -um	honorable	
honor	honor -ōris m.	"honor, glory; office, post"	
hora	hōra -ae f.	hour	
hortor	hortor hortārī hortātus sum	"urge strongly, advise, exhort"	
hospes	hospes hospitis m.	"guest, guest-friend; stranger; host"	
hostis	hostis -is m./f.	"stranger, enemy"	
huc	hūc	to this place	
humanus	hūmānus -a -um	human	
humus	humus -ī f.	ground; humī: on the ground	
iaceo	iaceō iacēre iacuī	lie	
iacio	iaciō iacere iēcī iactum	"throw, hurl"	
iam	iam	now; already	
ibi	ibi	there	
ictus2	īctus -ūs m.	"blow, stroke"	
idem	īdem eadem idem	the same	
ideo	ideō	for this reason	
igitur	igitur	therefore	
ignis	ignis -is m.	fire	
ille	ille illa illud	that	
illic2	illīc	"at that place, there"	
illinc	illinc	from that place	
illuc	illūc	to that place	
imago	imāgō -inis f.	"image, form, figure"	
imperator	imperātor -ōris m.	commander	
imperium	imperium -ī n.	"command, power"	
impero	imperō -āre	"command, control"	
impetus	impetus -ūs m.	attack	
impleo	impleō -ēre -plēvī -plētum	"fill in, fill up"	
impono	impōnō -ere -posuī -positum	"put in, put on, impose, levy upon"	
in	in	"in, on (+ abl.); into, onto (+ acc.)"	
incido2	incidō incidere incidī	"fall upon, fall into; happen"	
incipio	incipiō -cipere -cēpī -ceptum	begin	
inde	inde	"from there, from then"	
indico	indicō -āre	"point out, show, make known"	
infero	īnferō īnferre intulī illātum	"bring upon, against; bellum īnferre: make war on"	
inferus	īnferus -a -um	low; īnferior: lower; īnfimus or īmus: lowest	
ingenium	ingenium -ī n.	"disposition, ability, talent"	
ingens	ingēns ingentis	"huge, enormous"	
ingratus	ingrātus -a -um	"unpleasant, disagreeable"	
ingredior	ingredior -gredī -gressus sum	"step in, enter"	
inimicus	inimīcus -a -um	unfriendly; (as subst.) enemy	
initium	initium -ī n.	beginning	
iniuria	iniūria -ae f.	"injustice, wrong, affront"	
inquam	"inquam, inquis, inquit, inquiunt"	say (used with direct speech)	
instituo	īnstituō -stituere -stituī -stitūtum	undertake; equip	
insula	īnsula -ae f.	island	
integer	integer -gra -grum	"untouched, fresh, complete, whole"	
intellego	intellegō -legere -lēxī -lēctum	understand	
intendo	intendō -tendere -tendī -tentum	"stretch out, strain"	
inter	inter	"between, among; during (+ acc.)"	
interficio	interficiō -ficere -fēcī -fectum	kill	
interim	interim	meanwhile	
interrogo	interrogō -āre	"put a question to, ask (+ acc.)"	
intersum	intersum -esse -fuī	"to be between; take part in, attend (+ dat.); interest, it is in the interest of (+ gen.)"	
intra	intrā	within (+ acc.)	
intro2	intrō -āre	enter	
invenio	inveniō -venīre -vēnī -ventum	find; discover	
invidia	invidia -ae f.	"envy, jealousy, hatred"	
ipse	ipse ipsa ipsum	him- her- itself	
ira 	īra irae f.	"wrath, anger"	
irascor	īrāscor īrāscī īrātus sum	grow angry	
iratus	īrātus -a -um	angry	
is	is ea id	"he, she, it"	
iste	iste ista istud	"that, that of yours"	
istic2	istīc	over there	
istinc	istinc	from over there	
istuc	istūc	over there	
ita	ita	"thus, so"	
itaque	itaque	"and so, therefore"	
item	item	likewise	
iter	iter itineris n.	"journey, route"	
iterum	iterum	again	
iubeo	iubeō iubēre iussī iussum	"bid, order"	
iudex	iūdex iūdicis m.	"judge, juror"	
iudicium	iūdicium -ī n.	"judgment, decision, trial"	
iudico	iūdicō -āre	"judge, decide"	
iugum	iugum -ī n.	"yoke; ridge, chain of hills"	
iungo	iungō iungere iūnxī iūnctum	join	
iuro	iūrō -āre	"take an oath, swear; iūs iūrandum, oath"	
ius2	iūs iūris n.	"right, justice, law"	
iustus	iūstus -a -um	"right, just, fair"	
iuvenis	iuvenis -is m.	youth	
iuvo	iuvō iuvāre iūvī iūtum	"help, assist; please, delight"	
labor2	labor -ōris m.	"toil, exertion"	
laboro	labōrō -āre	"toil, work; be in trouble or distress"	
lacrima	lacrima -ae f.	tear	
laedo	laedō laedere laesī laesum	"injure by striking, hurt"	
laetus	laetus -a -um	"glad, joyful"	
lapis	lapis lapidis m.	stone	
lateo	lateō latēre latuī	"lie hidden, be hidden"	
latus	lātus -a -um	"broad, wide"	
latus2	latus -eris n.	"side, flank"	
laudo	laudō -āre	praise	
laus	laus laudis f.	"praise, glory"	
legatus	lēgātus -ī m.	"lieutenant, envoy"	
legio	legiō -ōnis f.	legion	
lego2	legō legere lēgī lēctum	"gather, choose, read"	
levis 	levis -e	"light, trivial"	
lex	lēx lēgis f.	law	
liber	līber lībera līberum	free; līberī	
liber2	līberī līberōrum m. pl.	freeborn children	
liber4	liber librī m.	book	
libertas	lībertās -ātis f.	freedom	
libet	libet libēre libuit or libitum est	it is pleasing (+ dat. + infin.)	
libido	libīdō -inis f.	"passion, lust"	
licet	licet licēre licuit licitum est	it is permitted (+ dat. + infin.)	
licet2	licet	even though	
limen	līmen līminis n.	threshold	
lingua	lingua -ae f.	tongue; language	
littera	littera -ae f.	"letter, (pl.) literature"	
litus3	lītus -oris n.	shore	
locus	locus -ī m.	place; loca (n. pl.) region	
longe	longē	"far, far off"	
longus	longus -a -um	"long, far"	
loquor	loquor loquī locūtus sum	"speak, talk"	
lumen	lūmen luminis n.	light	
luna	lūna -ae f.	moon	
lux	lūx lūcis f.	light of day	
maestus	maestus -a -um	"sad, sorrowful; depressing"	
magis	magis	more	
magister	magister magistrī m.	"master, chief"	
magnitudo	māgnitūdō -inis f.	"greatness, size"	
magnus	māgnus -a -um	great	
maiores	māiōrēs māiōrum m.	ancestors	
male	male	(adv.) badly	
malo	mālō mālle māluī	prefer	
malus	malus -a -um	"bad, evil"	
maneo	maneō manēre mānsī mānsum	remain	
manus	manus -ūs f.	hand; band of men	
mare	mare -is n.	sea	
maritus	marītus -ī m.	husband	
mater	māter mātris f.	mother	
materia	māteria -ae f.	"material, subject matter; timber, lumber"	
medius	medius -a -um	"middle, central"	
membrum	membrum -ī n.	"limb, member of the body"	
memini	meminī meminisse	"remember, recollect"	
memoria	memoria -ae f.	"recollection, memory"	
mens	mēns mentis f.	mind	
mensa	mēnsa -ae f.	table	
mereo	mereō merēre meruī meritum	"deserve, merit; serve as a soldier"	
metuo	metuō metuere metuī	"to fear, to dread"	
metus 	metus -ūs m.	"fear, dread"	
meus	meus -a -um	my	
miles	mīles -itis m.	soldier	
mille	mīlle (pl.) mīlia	thousand	
miror	mīror mīrārī mīrātus sum	"wonder at, marvel at (+ acc.)"	
misceo	misceō miscēre miscuī mixtum	mix	
miser	miser misera miserum	"wretched, pitiable"	
mitto	mittō mittere mīsī missum	"send, let go"	
modo	modo	"just, just now; modo ... modo: now ... now, at one moment ... at another, sometimes ... sometimes"	
modus	modus -ī m.	"measure, manner, kind"	
moenia	moenia -ium n. pl.	"walls, fortifications"	
mollis	mollis -e	"soft, yielding, gentle"	
moneo	moneō monēre monuī monitum	"warn, advise"	
mons	mōns montis m.	mountain	
mora	mora -ae f.	"delay, hindrance"	
morbus	morbus -ī m.	"sickness, disease"	
morior	morior morī mortuus sum	die	
moror	moror morārī morātus sum	delay	
mors	mors mortis f.	death	
mortalis	mortālis -e	"liable to death, mortal; (as subst.) a mortal"	
mos	mōs mōris m.	"custom, habit; (pl.) character"	
moveo	moveō -ēre mōvī mōtum	move	
mox	mox	soon	
mulier	mulier -eris f.	woman	
multitudo	multitūdō -inis f.	"multitude, number"	
multo	multō	by far	
multus	multus -a -um	"much, many"	
mundus	mundus -a -um	"clean, neat, elegant"	
mundus2	mundus -ī m.	"world, universe, heavens"	
munus	mūnus mūneris n.	"gift, offering; duty, obligation; (pl.) gladiatorial show"	
murus	mūrus -ī m.	wall	
muto	mūtō -āre	change	
nam	nam	"for, indeed, really"	
namque	namque	"for, indeed, really"	
narro	narrō -āre	"relate, recount"	
nascor	nāscor nāscī nātus sum	be born	
natura	nātūra -ae f.	nature	
natus	nātus -ī m.	son	
navis	nāvis -is f.	ship	
ne	nē	"lest, that not"	
ne2	ne (enclitic)	interrogative particle attached to the emphatic word in a question	
necesse	necesse (indecl. adj.)	necessary	
necessitas	necessitās -tātis f.	"necessity, need"	
nefas	nefās n. indecl.	"impiety, wickedness"	
nego	negō -āre	"deny, refuse"	
negotium	negōtium -ī n.	business	
nemo	nēmō	"no one (gen. nūllīus, dat. nūllī, abl. nūllō or nūllā → nūllus -a -um)"	
nemus	nemus nemoris n.	"grove, forest"	
neque	nec	"and not, nor; nec ... nec, neither ... nor; → neque"	
neque	neque	"and not, nor; neque ... neque, neither ... nor; → nec"	
nescio	nesciō -scīre	"not know, be ignorant"	
niger	niger nigra nigrum	black	
nihil	nihil or nīl	nothing; not at all	
nimis	nimis	excessively	
nimium	nimium	excessively	
nimius	nimius -a -um	"too much, excessive"	
nisi	nisi or nī	"if not, unless"	
nobilis	nōbilis -e	"distinguished, noble; (as subst.) a nobleman or woman"	
noceo	noceō nocēre nocuī	harm	
nolo	nōlō nōlle nōluī	be unwilling	
nomen	nōmen -inis n.	name	
non	nōn	not	
nondum	nōndum	not yet	
nōs	nōs nostrum/nostrī nōbīs nōs	we	
nosco	nōscō nōscere nōvī nōtum	"learn, know"	
noster	noster nostra nostrum	our	
notus	nōtus -a -um	well-known	
novus	novus -a -um	new	
nox	nox noctis f.	night	
nudus	nūdus -a -um	"naked, bare"	
nullus	nūllus -a -um	"not any, no one"	
num	num	interrogative particle implying negative answer	
numen	nūmen -inis n.	"divine will, deity"	
numerus	numerus -ī m.	"number, amount"	
numquam	numquam	never	
nunc	nunc	now	
nuntius	nūntius -ī m.	messenger; news	
ob	ob	"against, on account of (+ acc.)"	
occido	occīdō -cīdere -cīdī -cīsum	"kill, cut down"	
occupo	occupō -āre	"seize, occupy; anticipate, do a thing first (+ infin.)"	
occurro	occurrō -currere -cucurrī -cursum	run to meet; come into one’s mind	
oculus	oculus -ī m.	eye	
odi	ōdī ōdisse	hate	
odium	odium -ī n.	hatred	
offero	offerō offerre obtulī oblātum	"present, offer, expose"	
officium	officium -ī n.	"service, duty"	
olim	ōlim	"formerly, at that time"	
omnis	omnis -e	"all, every, as a whole"	
onus	onus oneris n.	"load, burden"	
opera	opera -ae f.	"labor, activity, work"	
oportet	oportet -ēre -uit	"it is proper, right (+ acc. + infin.)"	
oppidum	oppidum -ī n.	town	
ops	ops opis f.	"assistance, resources"	
opto	optō -āre	"choose, select"	
opus	opus operis n.	work	
oratio	ōrātiō -ōnis f.	"speech, address"	
orbis	orbis -is m.	circle; orbis terrārum: world	
ordo	ōrdō -īnis m.	"order, rank"	
orior	orior orīrī ortus sum	"arise, begin"	
oro	ōrō -āre	pray	
os	ōs ōris n.	"mouth, face"	
os2	os ossis n.	bone	
ostendo	ostendō ostendere ostendī ostentum	"show, hold out"	
otium	ōtium -ī n.	leisure	
paene	paene	almost	
par	pār paris	equal	
parco	parcō parcere pepercī parsum	"spare, be sparing of (+ dat.)"	
parens2	parēns -ntis m./f.	parent	
pareo	pāreō pārēre pāruī	obey	
pario2	pariō parere peperī partum	"bring forth, give birth to; accomplish"	
paro	parō -āre	"prepare, acquire; parātus -a -um, ready"	
pars	pars partis f.	part	
parum	parum	too little	
parvus	parvus -a -um	small	
pateo	pateō patēre patuī	"lie open, extend; be evident or obvious"	
pater	pater patris m.	"father, ancestor"	
patior	patior patī passus sum	"permit, endure"	
patria	patria -ae f.	"fatherland, country"	
paucus	paucī -ae -a	"few, a few"	
paulo	paulō	"to only a small extent, slightly, a little"	
paulum	paulum	"to only a small extent, slightly, a little"	
pauper	pauper -eris	"poor, lowly"	
pax	pāx pācis f.	peace	
pecco	peccō -āre	"commit a wrong, injure"	
pectus 	pectus -oris n.	"chest, breast"	
pecunia	pecūnia -ae f.	money	
pecus	pecus -oris n.	"cattle, sheep"	
pello	pellō pellere pepulī pulsum	"strike, beat, push, drive"	
pendo	pendō pendere pependī pēnsum	"weigh, hang, suspend; pay"	
per	per	through (+ acc.)	
perdo	perdō -dere -didī -ditum	destroy	
pereo 	pereō -īre -iī -itum	"perish, be lost"	
perficio	pergō pergere perrēxī perrēctum	"continue, proceed; awaken"	
periculum	perīculum -ī n.	danger	
permitto	permittō -mittere -mīsī -missum	"yield, allow, permit"	
perpetuus	perpetuus -a -um	"unbroken, perpetual"	
pertineo	pertineō -tinēre -tinuī	"extend over, reach; refer to, pertain to, be the business of"	
pervenio	perveniō -venīre -vēnī -ventum	"arrive, reach"	
pes	pēs pedis m.	foot	
peto	petō petere petīvī petītum	"seek, aim at"	
pietas	pietās -tātis f.	"sense of duty, devotion, esp. between parents and children"	
pius	pius -a -um	"dutiful, devoted, just, pious"	
placeo	placeō placēre placuī placitum	please	
plebs	plēbs plēbis f.	the common people	
plenus	plēnus -a -um	full	
plerumque	plērumque	generally	
plerusque	plērus- plēra- plērumque	"the greater part, very many, most, the majority"	
poena	poena -ae f.	"penalty, punishment"	
poeta	poēta -ae m.	poet	
pondus	pondus ponderis n.	weight	
pono	pōnō pōnere posuī positum	"put, place; put aside"	
pontus	pontus -ī m.	"the open sea, the deep"	
populus	populus -ī m.	people	
porta	porta -ae f.	gate	
porto	portō -āre	carry a load	
posco	pōscō pōscere popōscī	"demand, claim; inquire into"	
possum	possum posse potuī	be able	
post	post	after (adv. and prep. + acc.)	
postea	posteā	afterwards	
posterus	posterus -a -um	"next, later"	
postquam	postquam	after	
potens	potēns potentis	"able, powerful"	
potestas	potestās -ātis f.	power	
potis	potis -e	"powerful, able"	
praebeo	praebeō -ēre -uī -itum	"furnish, supply, render"	
praeceptum	praeceptum -ī n.	"rule, precept; command"	
praecipio	praecipiō -cipere -cēpī -ceptum	"anticipate, advise, warn"	
praeda	praeda -ae f.	"booty, prey"	
praemium	praemium -ī n.	"bounty, reward"	
praesens	praesēns -ntis	"present, in person, ready"	
praesidium	praesidium -ī n.	"garrison, protection"	
praesto2	praestō -stāre -stitī -stitum	"excel, exhibit"	
praeter	praeter	"by, along, past; besides, except (+ acc.)"	
praeterea	praetereā	"besides, moreover"	
praetor	praetor -ōris m.	"praetor, one of the chief Roman magistrates"	
precor	precor -ārī	"pray, invoke"	
premo	premō premere pressī pressum	"press, pursue, overwhelm"	
pretium	pretium -ī n.	"price, worth, reward; pretium operae: a reward for trouble"	
prex	prex precis f.	"prayers, entreaties"	
primum	prīmum	"at first, firstly"	
primus	prīmus -a -um	first	
princeps	prīnceps -cipis	"first, chief; (as subst.) leader, person in charge"	
principium	prīncipium -ī n.	beginning	
prior	prior prius	"earlier, preceding"	
prius	prius	before	
priusquam	priusquam	before	
privatus	prīvātus -a -um	"personal, private"	
pro	prō	"for, on behalf of, in proportion to (+ abl.)"	
probo	probō -āre	"approve, prove; convince one (dat.) of a thing (acc.)"	
procedo	prōcēdō -cēdere -cessī -cessum	"go forth, advance"	
procul	procul	at a distance	
prodo	prōdō prōdere prōdidī prōditum	"publish, hand down; give over, betray"	
proelium	proelium -ī n.	battle	
proficiscor	proficīscor -ficīscī -fectus sum	"set forth, go"	
prohibeo	prohibeō -ēre -uī -itum	"restrain, keep away"	
promitto	prōmittō -mittere -mīsī -missum	"send forth, offer"	
prope	prope	"near, next; (comp.) propior, (superl.) proximus; (adv.) prope, nearly, almost"	
propero	properō -āre	"hasten, speed"	
propono	prōpōnō -pōnere -posuī -positum	"put forth, propose, present"	
proprius	proprius -a -um	"one’s own, peculiar"	
propter	propter	because of (+ acc.)	
prosum	prōsum prodesse profuī	"be of use, do good, help (+ dat.)"	
protinus	prōtinus	"at once, forthwith"	
provincia	prōvincia -ae f.	province; official duty	
publicus	pūblicus -a -um	"public, belonging to the state"	
pudor	pudor pudōris m.	"sense of shame, modesty, propriety"	
puella	puella -ae f.	girl; girl-friend	
puer	puer puerī m.	boy; slave	
pugna	pūgna -ae f.	fist-fight; battle	
pugno	pugnō -āre	fight	
pulcher	pulcher -chra -chrum	beautiful	
puto	putō -āre	"think, suppose"	
qua	quā	"where, how"	
quaero	quaerō -rere -sīvī -sītum	"seek, inquire"	
qualis	quālis -e	of what kind? what?	
quam	quam	how?; (after comparative) than	
quamquam 	quamquam	"however, although"	
quamvis	quamvīs	however you like; although	
quando	quandō	when?; since; sī quandō: if ever	
quantum	quantum	(adv.) how much? how greatly? how much! how greatly! as much as	
quantus	quantus -a -um	"(interr.) how great? (rel.) of what size, amount, etc. (as subst.) what amount? (rel.) which amount; quantī, at what price? (rel.) at which price"	
quare	quārē	how? why?	
quasi	quasi	as if	
quattuor	quattuor	four	
que	que	and (postpositive enclitic)	
quemadmodum	quemadmodum	"in what manner, how"	
queror	queror querī questus sum	"complain of, lament"	
qui	quī quae quod	"who, which, what"	
quia	quia	because	
quicumque	quīcumque quaecumque quodcumque	"who-, whatever"	
quidam	quīdam quaedam quoddam	"a certain one, someone"	
quidem	quidem	"certainly, at least"	
quiesco	quiēscō quiēscere quiēvī quiētum	keep quiet; sleep	
quin	quīn	"(adv.) indeed, in fact; (conjunction) so that ... not (+ subj.)"	
quippe	quīppe	"(adv.) indeed, surely"	
quis	quis quid	who? what? which?	
quisquam	quisquam quicquam/quidquam	"any (single) person, anyone at all"	
quisque	quisque quaeque quidque	"each one, everyone"	
quisquis	quisquis quidquid	"whoever, whichever"	
quo	quō	"for which reason; to or in what place; to what end, for what purpose?"	
quomodo	quōmodo	"in what way, how?"	
quondam	quondam	"formerly, once"	
quoniam	quoniam	"since, seeing that"	
quoque	quoque	"also, too"	
quotiens	quotiēns	"interr. how many times? how often? rel. as often as, whenever"	
rapio	rapiō rapere rapuī raptum	"seize, tear away"	
rarus	rārus -a -um	"wide apart, loose, thin; rare, seldom"	
ratio	ratiō -ōnis f.	"method, plan, reason"	
recedo	recēdō -cēdere -cessī -cessum	"step back, recoil, recede, withdraw"	
recens	recēns -ntis	"fresh, new"	
recipio 	recipiō -cipere -cēpī -ceptum	"take back, receive; sē recipere, betake oneself, go"	
rectus	rēctus -a -um	"straight, direct"	
reddo	reddō -dere -didī -ditum	"return, give back"	
redeo	redeō -īre -iī -itum	"go back, return"	
refero	referō referre rettulī relātum	bring back; report	
regio	regiō -ōnis f.	"boundary, region"	
regius	rēgius -a -um	"kingly, royal"	
regnum 	rēgnum -ī n.	"kingship, kingdom"	
rego	regō regere rēxī rēctum	"guide, rule"	
relinquo	relinquō -linquere -līquī -lictum	abandon	
reliquus	reliquus -a -um	"remaining, rest"	
reor	reor rērī rātus sum	"think, imagine, suppose, deem"	
reperio	reperiō -perīre -pperī -pertum	"find, find out"	
repeto	repetō -petere -petīvī -petītum	"demand, exact; revisit; call to mind, recollect; repeat"	
res	rēs reī f.	"thing (rēs pūblica, commonwealth; rēs familiāris, family property, estate; rēs mīlitāris, art of war; rēs novae, revolution)"	
respicio	respicio -ere -spēxī -spectum	"look back, regard, consider"	
respondeo	respondeō -spondēre -spondī -spōnsum	answer	
retineo	retineō -tinēre -tinuī -tentum	"hold back, keep"	
reus	reus -ī m.	defendant	
reverto	revertō -vertere -vertī	turn back	
revoco	revocō -āre	"call back, recall"	
rex	rēx rēgis m.	king	
rideo	rīdeō -ēre rīsī rīsum	"laugh, laugh at"	
ripa	rīpa -ae f.	bank of a river	
rogo	rogō -āre	ask	
rumpo	rumpō rumpere rūpī ruptum	"break, rupture"	
rursus	rūrsus	"back, again"	
rus	rūs rūris n.	country	
sacer	sacer sacra sacrum	"holy, sacred"	
sacerdos	sacerdōs -dōtis m./f.	"priest, priestess"	
saeculum	saeculum -ī n.	"generation, age, century"	
saepe	saepe	often	
saevus	saevus -a -um	"fierce, raging, wrathful"	
salus	salūs -ūtis f.	"health, safety"	
sanctus	sānctus -a -um	"sacred, inviolable"	
sanguis	sanguis -inis m.	blood	
sanus	sānus -a -um	"sound, sane"	
sapiens	sapiēns -ntis	"wise; (as subst.) wise man, sage, philosopher"	
sapientia	sapientia -ae f.	wisdom	
sat	sat	"enough, sufficient, sufficiently"	
satis	satis	"enough, sufficient, sufficiently"	
saxum	saxum -ī n.	"rock, cliff, crag"	
scelus	scelus -eris n.	"crime, sin"	
scientia	scientia -ae f.	knowledge	
scilicet	scīlicet	"certainly, of course"	
scio	sciō -īre -īvī/-iī -ītum	know	
scribo	scrībō scrībere scrīpsī scrīptum	write	
secundus	secundus -a -um	following; favorable; (as numeral) second	
securus	sēcūrus -a -um	"free from care, tranquil; careless"	
sed	sed	but	
sedeo	sedeō sedēre sēdī sessum	sit	
sedes	sēdēs -is f.	"seat, abode, habitation"	
semel	semel	once	
semper	semper	"always, ever"	
senatus	senātus -ūs m.	senate	
senex	senex -is m.	"old man, elder; senior, older"	
sensus2	sēnsus -ūs m.	"feeling, emotion, sense"	
sententia	sententia -ae f.	"opinion, judgment"	
sentio	sentiō sentīre sēnsī sēnsum	"perceive, feel, hear, see"	
sepulcrum	sepulcrum -ī n.	"place of burial, tomb, grave"	
sequor	sequor sequī secūtus sum	follow	
sermo 	sermō -ōnis m.	"conversation, discourse"	
servio	serviō -īre	"be a slave, serve (+ dat.)"	
servo	servō -āre	"save, watch over"	
servus2	servus -ī m.	slave	
si	sī	if	
sic	sīc	"in this manner, thus; sīc ... ut: in the same way as"	
sicut	sīcut	just as	
sidus	sīdus -eris n.	"star, constellation"	
signum	sīgnum -ī n.	"sign, standard, mark"	
silva	silva -ae f.	"forest, grove"	
similis	similis -e	"like, similar"	
simul	simul	at the same time	
sine	sine	without (+ abl.)	
singulus	singulī -ae -a	one each	
sino	sinō sinere sīvī situm	"allow, let go"	
sinus	sinus -ūs m.	"fold of a garment; lap, bay, gulf"	
sive	seu	whether; seu ... seu: whether ... or → sīve	
sive	sīve	whether; sīve ... sīve: whether ... or → seu	
socius	socius -a -um	"friendly, allied"	
socius2	socius -ī m.	"partner, comrade"	
sol	sōl sōlis m.	sun	
soleo	soleō -ēre -uī -itum	be accustomed	
solum2	sōlum	"only, merely"	
solus	sōlus -a -um	"only, alone"	
solvo	solvō solvere solvī solūtum	"release, set sail"	
somnus	somnus -ī m.	"sleep, slumber; (pl.) dreams"	
sono	sonō sonāre sonuī sonitum	"sound, resound"	
soror	soror -ōris f.	sister	
sors	sors sortis f.	"lot, fate, destiny; oracle"	
spargo	spargō spargere sparsī sparsum	scatter	
spatium	spatium -ī n.	space	
species	speciēs -ēī f.	"aspect, appearance"	
specto	spectō -āre	"look at, consider"	
spero	spērō -āre	to hope	
spes	spēs speī f.	hope	
spiritus	spīritus -ūs m.	"breath, life, spirit"	
statim	statim	immediately	
statuo	statuō -ere -uī -ūtum	"set up, determine"	
stella	stella -ae f.	star	
sto	stō stāre stetī statum	stand	
studeo	studeō -ēre -uī	"be eager, be zealous, care for (+ dat.)"	
studium	studium -ī n.	"eagerness, zeal"	
sub	sub	"under, close to (+acc. or abl.)"	
subeo	subeō -īre -iī -itum	go under; endure	
subito	subitō	"suddenly, unexpectedly"	
sui	sui sibi sē/sēsē	"him- her- itself, themselves"	
sum	fore	[future infinitive]	
sum	sum esse fuī futūrum	"be, exist; fut. infin. often = fore, impf. subj. often = forem for essem"	
sumo	sūmō sūmere sūmpsī sūmptum	take up	
super2	super	over (adv. and prep. +acc.)	
superbus	superbus -a -um	"overbearing, proud, haughty"	
superi	superī -ōrum m. pl.	"those above, i.e. the gods"	
supero	superō -āre	"overcome, surpass, defeat"	
supersum	supersum -esse -fuī	"remain, survive; be superfluous (to)"	
superus	superus -a -um	"situated above, upper"	
supplicium	supplicium -ī n.	"punishment, penalty"	
supra	suprā	"above, beyond (adv. and prep. + acc.)"	
surgo	surgō surgere surrēxī surrēctum	rise	
suscipio	suscipiō -cipere -cēpī ceptum	take up	
sustineo	sustineō sustinēre sustinuī sustentum	"hold up, sustain"	
suus	suus -a -um	"his own, her own, its own"	
taceo	taceō -ēre -uī -itum	"be silent; tacitus -a -um, silent"	
talis	tālis tāle	such	
tam	tam	"so, so much"	
tamen	tamen	"nevertheless, still"	
tamquam	tamquam	"so as, just as"	
tandem	tandem	finally	
tango	tangō tangere tetigī tāctum	touch	
tantum2	tantum	only	
tantummodo	tantummodo	only	
tantus	tantus -a -um	"so great, so much; (as pronoun) such a quantity, so much; tantī, at such a price, of such worth"	
tardus	tardus -a -um	"slow, sluggish, lingering"	
tectum	tēctum -ī n.	"roof; building, house"	
tego	tegō tegere tēxī tēctum	"cover, conceal"	
tellus	tellus tellūris f.	earth	
telum	tēlum -ī n.	"missile, weapon, spear"	
tempestas	tempestas -tātis f.	"period of time, season; bad weather, storm"	
templum	templum -ī n.	consecrated ground; temple	
tempto	temptō -āre	"try, test"	
tempus	tempus -oris n.	time	
tendo	tendō tendere tetendī tentum	"stretch, extend, direct (one’s steps or course)"	
tenebrae	tenebrae -brārum f. pl.	"darkness, the shadows"	
teneo	teneō -ēre -uī tentum	"hold, keep"	
tener	tener -era -erum	tender	
tergum	tergum -ī n.	"back, rear; ā tergō: from the rear"	
terra	terra -ae f.	land	
terreo	terreō terrēre terruī territum	"terrify, frighten"	
tertius	tertius -a -um	third	
testis	testis -is m.	witness	
timeo	timeō -ēre -uī	"to fear, to dread"	
timor	timor -ōris m.	fear	
tollo	tollō tollere sustulī sublātum	"raise up, destroy"	
tot	tot	so many	
totus	tōtus -a -um	"whole, entire"	
trado	trādō -dere -didī -ditum	"hand over, yield"	
traho	trahō trahere trāxī trāctum	"drag, draw"	
transeo	trānseō -īre -iī -itum	go across	
tres 	trēs tria	three	
tribunus	tribūnus -ī m.	"tribune, title of various Roman officials, as mīlitum, plēbis, aerāriī"	
tristis	trīstis -e	"sad, solemn, grim"	
tu	tū tuī tibi tē	you (sing.)	
tu	vōs	"you (pl.); (gen.) vestrum/vestrī, (dat./abl.) vōbīs, (acc.) vōs"	
tum	tum	then	
tunc	tunc	then	
turba	turba -ae f.	"crowd, uproar"	
turbo	turbō -āre	"disturb, confuse"	
turpis	turpis -e	"ugly, unsightly; disgraceful"	
tutus	tūtus -a -um	"safe, protected"	
tuus	tuus -a -um	your	
ubi	ubi	"where, when"	
ullus	ūllus -a -um	"any, anyone"	
ultimus	ultimus -a -um	"farthest, final, last, ultimate"	
ultra	ultrā	"beyond, further (adv. and prep. + acc.)"	
umbra	umbra -ae f.	"shade, shadow"	
umquam	umquam	ever	
unda	unda -ae f.	"wave, flowing water, water"	
unde	unde	from where	
undique	undique	"from all sides, on all sides"	
unus	ūnus -a -um	one	
urbs	urbs urbis f.	city	
usque	ūsque	up to; continuously	
usus2	ūsus -ūs m.	"use, experience"	
ut	"ut, utī"	"as (+ indic.); so that, with the result that (+ subj.); (in questions) in what manner, how; (exclam.) to what an extent! how!"	
uterque	uterque utraque utrumque	each of two	
utilis	ūtilis -e	useful	
utor	ūtor ūtī ūsus sum	"use, consume, employ (+ abl.)"	
utrum	utrum	whether; utrum ... an: whether ... or	
uxor	uxor uxōris f.	wife	
vaco	vacō vacāre	"be empty, open, unoccupied"	
vacuus	vacuus -a -um	empty	
vagus	vagus -a -um	"wandering, shifting"	
valeo	valeō valēre valuī	"be strong, excel, be valid, prevail; valē: farewell!"	
valeo	validus -a -um	strong	
validus	vanus -a -um	"empty; false, deceitful"	
vanus	varius -a -um	"changing, varied, various"	
varius	vātēs -is m.	"poet, bard"	
ve	ve	or (postpositive enclitic)	
veho	vehō vehere vēxī vectum	"carry; vehor vehī vectus sum: travel, ride"	
vel	vel	"or else, or; even; vel ... vel: either … or"	
velut	velut	"even as, just as"	
venio	veniō venīre vēnī ventum	come	
ventus	ventus -ī m.	wind	
verbum	verbum -ī n.	word	
vere	vērē	truly	
vereor	vereor verērī veritus sum	"fear, stand in awe of"	
vero	vērō	"in fact, certainly, without doubt"	
verto	vertō vertere vertī versum	turn	
verus	vērus -a -um	true	
vester	vester vestra vestrum	your	
vestigium	vestīgium -ī n.	"footstep, footprint, track"	
vestis	vestis -is f.	"garment, robe, clothing"	
veto	vetō -āre vetuī vetītum	forbid	
vetus	vetus veteris	old	
via	via -ae f.	"way, street"	
vicinus	vīcīnus -a -um	"neighboring, near"	
victor	victor -ōris m.	conqueror	
victoria	victōria -ae f.	victory	
video	videō vidēre vīdī vīsum	see	
vinco	vincō vincere vīcī victum	conquer	
vinculum	vinculum -ī n.	"bond, fetter, tie"	
vinum	vīnum -ī n.	"vine, wine"	
vir	vir virī m.	man	
virgo	virgō -inis f.	"maiden, virgin, girl"	
virtus	virtūs -ūtis f.	"valor, manliness, virtue"	
vis	vīs f.	"force; (acc.) vim, (abl.) vī; (pl.) vīrēs, strength"	
vita	vīta -ae f.	life	
vitium	vitium -ī n.	"flaw, fault, crime"	
vito	vītō -āre	"avoid, shun"	
vivo	vīvō vīvere vīxī vīctum	live	
vix	vix	scarcely	
voco	vocō -āre	call	
volo	volō velle voluī	"wish, be willing"	
volucer	volucer -cris -cre	flying	
volucris	volucris -is f./m.	bird	
voluntas	voluntās -ātis f.	"wish, desire"	
voluptas	voluptās -ātis f.	"pleasure, enjoyment"	
votum	vōtum -ī n.	"solemn promise, vow; hope"	
vox	vōx vōcis f.	"voice, utterance"	
vulgo	vulgō	commonly	
vulgus	vulgus -ī n. and m.	the common people	
vulnus	vulnus -eris n.	wound	
vultus	vultus -ūs m.	"look, expression, face"	