ululare	ululo
ululari	ululo
ulula	ululo
ululate	ululo
ululato	ululo
ululatote	ululo
ululans	ululo
ululantis	ululo
ululanti	ululo
ululantem	ululo
ululante	ululo
ululantes	ululo
ululantium	ululo
ululantibus	ululo
ululantia	ululo
ululaturus	ululo
ululatura	ululo
ululaturae	ululo
ululaturam	ululo
ululaturum	ululo
ululaturo	ululo
ululaturi	ululo
ululaturarum	ululo
ululaturis	ululo
ululaturas	ululo
ululaturorum	ululo
ululaturos	ululo
ululanda	ululo
ululandae	ululo
ululandam	ululo
ululandus	ululo
ululandi	ululo
ululandum	ululo
ululando	ululo
ululandarum	ululo
ululandis	ululo
ululandas	ululo
ululandorum	ululo
ululandos	ululo
ululo	ululo
ululas	ululo
ululat	ululo
ululamus	ululo
ululatis	ululo
ululant	ululo
ululabo	ululo
ululabis	ululo
ululabit	ululo
ululabimus	ululo
ululabitis	ululo
ululabunt	ululo
ululabam	ululo
ululabas	ululo
ululabat	ululo
ululabamus	ululo
ululabatis	ululo
ululabant	ululo
ululor	ululo
ulularis	ululo
ululatur	ululo
ululamur	ululo
ululamini	ululo
ululantur	ululo
ululabor	ululo
ululaberis	ululo
ululabitur	ululo
ululabimur	ululo
ululabimini	ululo
ululabuntur	ululo
ululabar	ululo
ululabaris	ululo
ululabatur	ululo
ululabamur	ululo
ululabamini	ululo
ululabantur	ululo
ululem	ululo
ulules	ululo
ululet	ululo
ululemus	ululo
ululetis	ululo
ululent	ululo
ulularem	ululo
ululares	ululo
ulularet	ululo
ulularemus	ululo
ulularetis	ululo
ulularent	ululo
ululer	ululo
ululeris	ululo
ululetur	ululo
ululemur	ululo
ululemini	ululo
ululentur	ululo
ulularer	ululo
ululareris	ululo
ulularetur	ululo
ulularemur	ululo
ulularemini	ululo
ulularentur	ululo
ululavi	ululo
ululavisti	ululo
ululavit	ululo
ululavimus	ululo
ululavistis	ululo
ululaverunt	ululo
ululavero	ululo
ululaveris	ululo
ululaverit	ululo
ululaverimus	ululo
ululaveritis	ululo
ululaverint	ululo
ululaveram	ululo
ululaveras	ululo
ululaverat	ululo
ululaveramus	ululo
ululaveratis	ululo
ululaverant	ululo
ululaverim	ululo
ululavissem	ululo
ululassem	ululo
ululavisses	ululo
ululavisset	ululo
ululavissemus	ululo
ululavissetis	ululo
ululavissent	ululo
ululatus	ululo
ululati	ululo
vlulare	ululo
vlulari	ululo
vlula	ululo
vlulate	ululo
vlulato	ululo
vlulatote	ululo
vlulans	ululo
vlulantis	ululo
vlulanti	ululo
vlulantem	ululo
vlulante	ululo
vlulantes	ululo
vlulantium	ululo
vlulantibus	ululo
vlulantia	ululo
vlulaturus	ululo
vlulatura	ululo
vlulaturae	ululo
vlulaturam	ululo
vlulaturum	ululo
vlulaturo	ululo
vlulaturi	ululo
vlulaturarum	ululo
vlulaturis	ululo
vlulaturas	ululo
vlulaturorum	ululo
vlulaturos	ululo
vlulanda	ululo
vlulandae	ululo
vlulandam	ululo
vlulandus	ululo
vlulandi	ululo
vlulandum	ululo
vlulando	ululo
vlulandarum	ululo
vlulandis	ululo
vlulandas	ululo
vlulandorum	ululo
vlulandos	ululo
vlulo	ululo
vlulas	ululo
vlulat	ululo
vlulamus	ululo
vlulatis	ululo
vlulant	ululo
vlulabo	ululo
vlulabis	ululo
vlulabit	ululo
vlulabimus	ululo
vlulabitis	ululo
vlulabunt	ululo
vlulabam	ululo
vlulabas	ululo
vlulabat	ululo
vlulabamus	ululo
vlulabatis	ululo
vlulabant	ululo
vlulor	ululo
vlularis	ululo
vlulatur	ululo
vlulamur	ululo
vlulamini	ululo
vlulantur	ululo
vlulabor	ululo
vlulaberis	ululo
vlulabitur	ululo
vlulabimur	ululo
vlulabimini	ululo
vlulabuntur	ululo
vlulabar	ululo
vlulabaris	ululo
vlulabatur	ululo
vlulabamur	ululo
vlulabamini	ululo
vlulabantur	ululo
vlulem	ululo
vlules	ululo
vlulet	ululo
vlulemus	ululo
vluletis	ululo
vlulent	ululo
vlularem	ululo
vlulares	ululo
vlularet	ululo
vlularemus	ululo
vlularetis	ululo
vlularent	ululo
vluler	ululo
vluleris	ululo
vluletur	ululo
vlulemur	ululo
vlulemini	ululo
vlulentur	ululo
vlularer	ululo
vlulareris	ululo
vlularetur	ululo
vlularemur	ululo
vlularemini	ululo
vlularentur	ululo
vlulavi	ululo
vlulavisti	ululo
vlulavit	ululo
vlulavimus	ululo
vlulavistis	ululo
vlulaverunt	ululo
vlulavero	ululo
vlulaveris	ululo
vlulaverit	ululo
vlulaverimus	ululo
vlulaveritis	ululo
vlulaverint	ululo
vlulaveram	ululo
vlulaveras	ululo
vlulaverat	ululo
vlulaveramus	ululo
vlulaveratis	ululo
vlulaverant	ululo
vlulaverim	ululo
vlulavissem	ululo
vlulassem	ululo
vlulavisses	ululo
vlulavisset	ululo
vlulavissemus	ululo
vlulavissetis	ululo
vlulavissent	ululo
vlulatus	ululo
vlulati	ululo
vlvlare	ululo
vlvlari	ululo
vlvla	ululo
vlvlate	ululo
vlvlato	ululo
vlvlatote	ululo
vlvlans	ululo
vlvlantis	ululo
vlvlanti	ululo
vlvlantem	ululo
vlvlante	ululo
vlvlantes	ululo
vlvlantium	ululo
vlvlantibus	ululo
vlvlantia	ululo
vlvlaturus	ululo
vlvlatura	ululo
vlvlaturae	ululo
vlvlaturam	ululo
vlvlaturum	ululo
vlvlaturo	ululo
vlvlaturi	ululo
vlvlaturarum	ululo
vlvlaturis	ululo
vlvlaturas	ululo
vlvlaturorum	ululo
vlvlaturos	ululo
vlvlanda	ululo
vlvlandae	ululo
vlvlandam	ululo
vlvlandus	ululo
vlvlandi	ululo
vlvlandum	ululo
vlvlando	ululo
vlvlandarum	ululo
vlvlandis	ululo
vlvlandas	ululo
vlvlandorum	ululo
vlvlandos	ululo
vlvlo	ululo
vlvlas	ululo
vlvlat	ululo
vlvlamus	ululo
vlvlatis	ululo
vlvlant	ululo
vlvlabo	ululo
vlvlabis	ululo
vlvlabit	ululo
vlvlabimus	ululo
vlvlabitis	ululo
vlvlabunt	ululo
vlvlabam	ululo
vlvlabas	ululo
vlvlabat	ululo
vlvlabamus	ululo
vlvlabatis	ululo
vlvlabant	ululo
vlvlor	ululo
vlvlaris	ululo
vlvlatur	ululo
vlvlamur	ululo
vlvlamini	ululo
vlvlantur	ululo
vlvlabor	ululo
vlvlaberis	ululo
vlvlabitur	ululo
vlvlabimur	ululo
vlvlabimini	ululo
vlvlabuntur	ululo
vlvlabar	ululo
vlvlabaris	ululo
vlvlabatur	ululo
vlvlabamur	ululo
vlvlabamini	ululo
vlvlabantur	ululo
vlvlem	ululo
vlvles	ululo
vlvlet	ululo
vlvlemus	ululo
vlvletis	ululo
vlvlent	ululo
vlvlarem	ululo
vlvlares	ululo
vlvlaret	ululo
vlvlaremus	ululo
vlvlaretis	ululo
vlvlarent	ululo
vlvler	ululo
vlvleris	ululo
vlvletur	ululo
vlvlemur	ululo
vlvlemini	ululo
vlvlentur	ululo
vlvlarer	ululo
vlvlareris	ululo
vlvlaretur	ululo
vlvlaremur	ululo
vlvlaremini	ululo
vlvlarentur	ululo
vlvlavi	ululo
vlvlavisti	ululo
vlvlavit	ululo
vlvlavimus	ululo
vlvlavistis	ululo
vlvlaverunt	ululo
vlvlavero	ululo
vlvlaveris	ululo
vlvlaverit	ululo
vlvlaverimus	ululo
vlvlaveritis	ululo
vlvlaverint	ululo
vlvlaveram	ululo
vlvlaveras	ululo
vlvlaverat	ululo
vlvlaveramus	ululo
vlvlaveratis	ululo
vlvlaverant	ululo
vlvlaverim	ululo
vlvlavissem	ululo
vlvlassem	ululo
vlvlavisses	ululo
vlvlavisset	ululo
vlvlavissemus	ululo
vlvlavissetis	ululo
vlvlavissent	ululo
vlvlatus	ululo
vlvlati	ululo
ulvlare	ululo
ulvlari	ululo
ulvla	ululo
ulvlate	ululo
ulvlato	ululo
ulvlatote	ululo
ulvlans	ululo
ulvlantis	ululo
ulvlanti	ululo
ulvlantem	ululo
ulvlante	ululo
ulvlantes	ululo
ulvlantium	ululo
ulvlantibus	ululo
ulvlantia	ululo
ulvlaturus	ululo
ulvlatura	ululo
ulvlaturae	ululo
ulvlaturam	ululo
ulvlaturum	ululo
ulvlaturo	ululo
ulvlaturi	ululo
ulvlaturarum	ululo
ulvlaturis	ululo
ulvlaturas	ululo
ulvlaturorum	ululo
ulvlaturos	ululo
ulvlanda	ululo
ulvlandae	ululo
ulvlandam	ululo
ulvlandus	ululo
ulvlandi	ululo
ulvlandum	ululo
ulvlando	ululo
ulvlandarum	ululo
ulvlandis	ululo
ulvlandas	ululo
ulvlandorum	ululo
ulvlandos	ululo
ulvlo	ululo
ulvlas	ululo
ulvlat	ululo
ulvlamus	ululo
ulvlatis	ululo
ulvlant	ululo
ulvlabo	ululo
ulvlabis	ululo
ulvlabit	ululo
ulvlabimus	ululo
ulvlabitis	ululo
ulvlabunt	ululo
ulvlabam	ululo
ulvlabas	ululo
ulvlabat	ululo
ulvlabamus	ululo
ulvlabatis	ululo
ulvlabant	ululo
ulvlor	ululo
ulvlaris	ululo
ulvlatur	ululo
ulvlamur	ululo
ulvlamini	ululo
ulvlantur	ululo
ulvlabor	ululo
ulvlaberis	ululo
ulvlabitur	ululo
ulvlabimur	ululo
ulvlabimini	ululo
ulvlabuntur	ululo
ulvlabar	ululo
ulvlabaris	ululo
ulvlabatur	ululo
ulvlabamur	ululo
ulvlabamini	ululo
ulvlabantur	ululo
ulvlem	ululo
ulvles	ululo
ulvlet	ululo
ulvlemus	ululo
ulvletis	ululo
ulvlent	ululo
ulvlarem	ululo
ulvlares	ululo
ulvlaret	ululo
ulvlaremus	ululo
ulvlaretis	ululo
ulvlarent	ululo
ulvler	ululo
ulvleris	ululo
ulvletur	ululo
ulvlemur	ululo
ulvlemini	ululo
ulvlentur	ululo
ulvlarer	ululo
ulvlareris	ululo
ulvlaretur	ululo
ulvlaremur	ululo
ulvlaremini	ululo
ulvlarentur	ululo
ulvlavi	ululo
ulvlavisti	ululo
ulvlavit	ululo
ulvlavimus	ululo
ulvlavistis	ululo
ulvlaverunt	ululo
ulvlavero	ululo
ulvlaveris	ululo
ulvlaverit	ululo
ulvlaverimus	ululo
ulvlaveritis	ululo
ulvlaverint	ululo
ulvlaveram	ululo
ulvlaveras	ululo
ulvlaverat	ululo
ulvlaveramus	ululo
ulvlaveratis	ululo
ulvlaverant	ululo
ulvlaverim	ululo
ulvlavissem	ululo
ulvlassem	ululo
ulvlavisses	ululo
ulvlavisset	ululo
ulvlavissemus	ululo
ulvlavissetis	ululo
ulvlavissent	ululo
ulvlatus	ululo
ulvlati	ululo
fire	fio
firi	fio
fi	fio
fite	fio
fito	fio
fitote	fio
fiens	fio
fientis	fio
fienti	fio
fientem	fio
fiente	fio
fientes	fio
fientium	fio
fientibus	fio
fientia	fio
fiturus	fio
fitura	fio
fiturae	fio
fituram	fio
fiturum	fio
fituro	fio
fituri	fio
fiturarum	fio
fituris	fio
fituras	fio
fiturorum	fio
fituros	fio
fienda	fio
fiendae	fio
fiendam	fio
fiendus	fio
fiendi	fio
fiendum	fio
fiendo	fio
fiendarum	fio
fiendis	fio
fiendas	fio
fiendorum	fio
fiendos	fio
fio	fio
fis	fio
fit	fio
fimus	fio
fitis	fio
fiunt	fio
fiam	fio
fies	fio
fiet	fio
fiemus	fio
fietis	fio
fient	fio
fiebam	fio
fiebas	fio
fiebat	fio
fiebamus	fio
fiebatis	fio
fiebant	fio
fior	fio
firis	fio
fitur	fio
fimur	fio
fimini	fio
fiuntur	fio
fiar	fio
fieris	fio
fietur	fio
fiemur	fio
fiemini	fio
fientur	fio
fiebar	fio
fiebaris	fio
fiebatur	fio
fiebamur	fio
fiebamini	fio
fiebantur	fio
fiam	fio
fias	fio
fiat	fio
fiamus	fio
fiatis	fio
fiant	fio
fierem	fio
fieres	fio
fieret	fio
fieremus	fio
fieretis	fio
fierent	fio
fiar	fio
fiaris	fio
fiatur	fio
fiamur	fio
fiamini	fio
fiantur	fio
firer	fio
fireris	fio
firetur	fio
firemur	fio
firemini	fio
firnentur	fio
fivi	fio
fivisti	fio
fivit	fio
fivimus	fio
fivistis	fio
fiverunt	fio
fivero	fio
fiveris	fio
fiverit	fio
fiverimus	fio
fiveritis	fio
fiverint	fio
fiveram	fio
fiveras	fio
fiverat	fio
fiveramus	fio
fiveratis	fio
fiverant	fio
fiverim	fio
fivissem	fio
fivisses	fio
fivisset	fio
fivissemus	fio
fivissetis	fio
fivissent	fio
fitus	fio
fiti	fio
