lemma	headword	definition	chapter
ne2	-ne	[signals a yes/no question]	1
que	-que	and	2
ve	-ve	or	30
sui	"—, suī, sibi, sē, sē"	"himself, herself, itself, themselves"	13
ab	ā	away from [+ abl.]	4
ab	ā	by [+ abl.]	14
ab	ab	away from [+ abl.]	4
ab	ab	by [+ abl.]	14
abeo	"abeō, abīre, abiī (or -īvī) abitūrus"	"to go away, depart"	23
absum	"absum, abesse, āfuī, āfutūrus"	"to be present, be near"	12
atque	ac	and	10
accido	"accidō, accidere, accidī, —"	to fall at/near; happen	24
accipio	"accipiō, accipere, accēpī, acceptus"	to receive	13
acer2	"ācer, ācris, ācre"	"sharp, fierce; eager"	10
acies	"aciēs, aciēī, f."	battle line	16
ad	ad	"to, toward [+ acc.]"	4
adeo	"adeō, adīre, adiī (or -īvī) aditūrus"	"to go towards, approach"	23
affero	"adferō, adferre, attulī, adlātus"	to bring to; cause 	23
adsum	"adsum, adesse, adfuī, adfutūrus"	"to be present, be near"	24
advenio	"adveniō, advenīre, advēnī, adventūrus"	"to arrive, come to; happen"	21
adventus	"adventus, adventūs, m."	arrival	18
aedifico	"aedificō, aedificāre, aedificāvī, aedificātus"	to build	3
aeger	"aeger, aegra, aegrum"	"sick, weak"	5
	"Aenēās, Aenēae, m."	Aeneas [leader of the Trojans]	30
aequus	"aequus, aequa, aequum"	"even, calm, equal"	15
aestus	"aestus, aestūs, m."	heat; tide	18
aetas	"aetās, aetātis, f."	"age, life"	11
ager	"ager, agrī, m."	(cultivated) field; countryside	2
ago	"agō, agere, ēgī, actus"	"to do, perform; drive"	8
agricola	"agricola, agricolae, m."	farmer	1
aio	"āiō, ait, aiunt"	"I say, (s)he says, they say"	19
alius	aliī … aliī	some … others	11
aliquis	"aliquis, aliquid"	"someone, something, anyone, anything"	26
alius	aliud … aliud	one thing … another thing	11
alius	"alius, alia, aliud"	"other, another; (pl.) others, some"	11
alter	"alter, altera, alterum"	"the one, the other (of two); next, second"	11
altus	"altus, alta, altum"	"high, deep"	5
ambulo	"ambulō, ambulāre, ambulāvī, ambulātūrus"	to walk	4
amicitia	"amīcitia, amīcitiae, f."	friendship	27
amicus	"amīcus, amīca, amīcum"	friendly (to)	12
amicus2	"amīcus, amīcī, m."	friend	2
amitto	"āmittō, āmittere, āmīsī, āmissus"	to lose	14
amo	"amō, amāre, amāvi, amātus"	to love	1
amor	"amor, amōris, m."	love	17
an	an	or	24
animus	"anīmus, animī, m."	"mind, spirit, courage; soul"	2
annus	"annus, annī, m."	year	11
ante	ante	"before [of space or time], in front; previously"	19
ante	ante	"before, in front of [+ acc.]"	9
antequam	antequam	before	12
appello2	"appellō, appellāre, appellāvī, appellātus"	"to name, call upon, address"	24
appropinquo	"appropinquō, appropinquāre, appropinquāvī, appropinquātūrus"	"to approach, draw near"	26
aptus	"aptus, apta, aptum"	"fit, suitable (for)"	12
apud 	apud	"among, with, near, at (the house of) [+ acc.]"	28
aqua	"aqua, aquae, f."	water	1
arbitror	"arbitror, arbitrārī, arbitrātus sum"	"to think, judge"	22
arbor	"arbor, arboris, f."	tree	12
ardeo	"ardeō, ardēre, arsī, arsūrus"	"to burn, be on fire, glow"	16
arma	"arma, armōrum, n. pl."	"arms, weapons"	3
ars	"ars, artis, f. "	"skill, art"	10
arx	"arx, arcis, f. "	"citadel, summit"	18
asper	"asper, aspera, asperum"	"rough, harsh; cruel"	32
at	at	but; at least; then	25
atque	atque	and	10
audeo	"audeō, audēre, ausus sum"	to dare	2
audio	"audiō, audīre, audīvī, audītus"	"to hear, listen (to)"	8
aufero	"auferō, auferre, abstulī, ablātus"	"to carry away, take away"	23
aura	"aura, aurae, f."	"breeze, air"	30
aureus	"aureus, aurea, aureum"	"golden, of gold"	18
aurum	"aurum, aurī, n."	gold	18
aut	aut	or	9
aut	aut … aut	either … or	9
autem	autem	however; on the contrary	25
auxilium	"auxilium, auxiliī, n."	"aid, help; [in pl. often] auxiliary troops"	18
beatus	"beātus, beāta, beātum"	"happy, blessed; prosperous"	24
bellum	"bellum, bellī, n."	war	2
bene	bene	well	19
bibo	"bibō, bibere, bibī, bibitūrus"	to drink	24
bonus	"bonus, bona, bonum"	good	5
brevis	"brevis, breve"	"brief, short"	10
cado	"cadō, cadere, cecidī, cāsūrus"	to fall	16
caedes	"caedēs, caedis, f."	"slaughter, murder"	19
caedo	"caedō, caedere, cecīdī, caesus"	"to kill, cut; sacrifice [of animals]"	19
caelum	"caelum, caelī, n."	"sky, heavens"	3
	"Caesar, Caesaris, m."	Julius Caesar [a Roman general]	17
canis	"canis, canis, m. or f."	dog	28
cano	"canō, canere, cecinī, cantus"	to sing	17
capio	"capiō, capere, cēpī, captus"	"to take, seize, capture"	8
caput	"caput, capitis, n."	head; summit	7
careo	"careō, carēre, caruī, caritūrus"	"to be without, free from; need, miss [+ abl.]"	7
carmen	"carmen, carminis, n."	"song, poem"	9
carus	"cārus, cāra, cārum"	dear (to)	12
casa	"casa, casae, f."	"house, hut"	2
castrum	"castra, castrōrum, n. pl."	camp	17
casus	"cāsus, cāsūs, m."	"fall; misfortune, destruction; chance, accident"	16
causa	causā	"for the sake of, because of [+ gen.]"	10
causa	"causa, causae, f."	"cause, reason"	10
celer	"celer, celeris, celere"	"swift, quick, rapid"	10
celeriter	celeriter	quickly	20
celsus	"celsus, celsa, celsum"	high	30
cena	"cēna, cēnae, f."	dinner	3
centum	centum	hundred	11
cerno	"cernō, cernere, crēvī, crētus"	"to see, discern, perceive, decide"	19
certe	certē	"certainly, surely, of course; at least"	25
certus	"certus, certa, certum"	"fixed, established, certain; specified; reliable, sure"	25
ceterus	"cēterī, cētera, cētera"	"the rest, the others"	15
cibus	"cibus, cibī, m."	food	22
circa	circā	around [+ acc.]	15
circiter	circiter	"about, near"	30
circum	circum	around [+ acc.]	15
civilis	"cīvīlis, cīvīle"	"civil, public, political"	29
civis	"cīvis, cīvis, m./f. "	citizen	15
civitas	"cīvitās, cīvitātis, f."	state; citizenship	7
clamo	"clāmō, clāmāre, clāmāvī, clāmātus"	to shout	2
clamor	"clāmor, clāmōris, m. "	shout; cheer	17
clarus	"clārus, clāra, clārum"	"clear, bright; famous; loud"	9
coepi	"coepī, coepisse, coeptus"	began [ a “defective” verb with no present system]	30
cogito	"cōgitō, cōgitāre, cōgitāvī, cōgitātus"	"to think, consider"	19
cognosco	"cognōscō, cognōscere, cognōvī, cognitus"	"to learn, recognize, understand"	18
cogo	"cōgō, cōgere, coēgī, coāctus"	"to force, compel; collect"	20
committo	"committō, committere, commīsī, commissus"	"to join, unite, engage in"	29
communis	"commūnis, commūne"	"shared, common; public"	21
concedo	"concēdō, concēdere, concessī, concessūrus"	"to go away, withdraw; yield to, submit; allow; forgive"	27
concurro	"concurrō, concurrere, concucurrī, concursūrsus"	"to charge, rush together, clash"	13
condo	"condō, condere, condidī, conditus"	"to found, build, establish"	15
confero	"cōnferō, cōnferre, contulī, collātus"	"to bring together, collect; compare; contribute"	23
conficio	"cōnficiō, cōnficere, cōnfēcī, cōnfectus"	"to finish, accomplish; weaken, kill"	21
coniunx	"coniūnx, coniugis, m./f."	wife; husband; spouse	9
conor	"cōnor, cōnārī, conātus sum"	to try	22
conservo	"cōnservō, cōnservāre, cōnservāvī, cōnservātus"	"to save, preserve, keep"	27
consilium	"cōnsilium, cōnsiliī, n."	"plan, advice"	2
conspicio	"cōnspiciō, cōnspicere, cōnspexi, cōnspectus"	"to observe, catch sight of, look at"	27
constituo	"cōnstituō, cōnstituere, cōnstituī, cōnstitūtus"	"to decide, appoint, establish"	14
consul	"cōnsul, cōnsulis, m."	consul	7
contra	contrā	in reply; face to face	14
contra	contrā	opposite; against [+ acc.]	14
convenio	"conveniō, convenīre, convēnī, conventūrus"	"to assemble, gather; meet; agree"	29
copia	"cōpia, cōpiae, f."	"abundance, plenty, resources, wealth; [pl.] troops"	19
cornu	"cornū, cornūs, n."	horn; wing (of an army)	16
corpus	"corpus, corporis, n."	"body, corpse"	7
credo	"crēdō, crēdere, crēdidī, crēditus"	"to believe, trust [+ dat. of person believed; + acc. of thing believed)"	9
creo	"creō, creāre, creāvī, creātus"	"to create; elect, choose"	8
crimen	"crīmen, crīminis, n."	"crime; accusation, charge"	17
culpa	"culpa, culpae, f."	"fault, blame"	22
cum2	cum	when	12
cum2	cum	"because, since, although"	26
cum	cum	with [+ abl.]	5
cunctus	"cunctus, cuncta, cunctum"	"the whole, all [collectively]"	23
cupiditas	"cupiditās, cupiditātis, f."	"desire, wish, longing, eagerness"	25
cupido	"cupīdō, cupidinis, f."	"desire, wish, longing, eagerness"	25
cupio	"cupiō, cupere, cupīvī or cupiī, cupītus"	"to want, desire"	20
cur 	cūr	why	25
cura	"cūra, cūrae, f."	"care, anxiety"	5
curo	"cūrō, cūrāre, cūrāvī, cūrātus"	"to care for/about, pay attention to; cure"	21
curro	"currō, currere, cucurrī, cursus"	to run	13
de2	dē	"down from; about, concerning [+ abl.]"	6
dea	"dea, deae, f."	goddess	3
debeo	"dēbeō, dēbēre, dēbui, dēbitus"	"""ought to, should""; to owe; to be obligated to"	1
deinde	deinde	"then, next"	30
deleo	"dēleō, dēlēre, dēlēvī, dēlētus"	to destroy; blot out	21
denique	dēnique	"finally, at last; in short; in fact"	24
despero	"dēspērō, dēspērāre, dēspērāvī, dēspērātus"	to despair	24
deus	"deus, deī, m."	god	3
dexter	"dexter, dextra, dextrum"	right (side); [fem.] right hand; pledge (of friendship)	9
dico2	"dīcō, dīcere, dīxī, dīctus"	"to say, speak, tell"	8
dies 	"diēs, diēī, m. or f."	day (fem. used when it is an appointed or set day)	16
difficilis	"difficilis, difficile"	difficult	10
dignus	"dignus, digna, dignum"	"worthy; worth, fitting [+ abl. or gen.]"	15
dimitto	"dīmittō, dīmittere, dīmīsī, dīmissus"	"to send away, send forth; dismiss; abandon"	24
dirus	"dīrus, dīra, dīrum"	"awful, horrible"	26
discedo	"discēdō, discēdere, discessī, discessūrus"	"to depart, go away; separate"	11
disco	"discō, discere, didicī, —"	to learn	13
diu	diū	for a long time	6
divinus	"dīvīnus, dīvīna, dīvīnum"	"divine, of the gods; prophetic"	5
do	"dō, dare, dedī, datus"	to give	3
doceo	"doceō, docēre, docuī, doctus"	"to teach (often with 2 accusatives: one of the person, the other of the thing taught)"	8
doleo	"doleō, dolēre, doluī, dolitūrus"	"to grieve, mourn, suffer pain"	6
dolor	"dolor, dolōris, m."	"pain, sorrow"	15
dolus	"dolus, dolī, m."	"trick, deceit"	19
dominus	"dominus, dominī, m."	"master, lord"	2
domus	"domus, domūs, f."	"house(hold), home"	16
donum	"dōnum, dōnī, n."	"gift, present"	2
dormio	"dormiō, dormīre, dormīvī, dormitūrus"	to sleep	8
dubito	"dubitō, dubitāre, dubitāvī, dubitātus"	"to hesitate, doubt"	2
duco 	"dūcō, dūcere, dūxī, ductus"	to lead	8
dulcis	"dulcis, dulce"	sweet; pleasant	10
dum	dum	"while, as long as [with indicative]"	12
dum	dum	until [with subjunctive]	26
duo	"duō, duae, duō"	two	11
durus	"dūrus, dūra, dūrum"	"hard, harsh, rough"	31
dux	"dux, ducis, m."	"(military) leader, commander"	7
ex	ē	"out of, from [+ abl.]"	4
efficio	"efficiō, efficere, effēcī, effectus"	"to bring about, produce"	18
ego	"ego, meī, mihi, mē, mē"	"I, me"	7
nos	"nōs, nostrum (nostrī), nōbīs, nōs, nōbīs"	"we, us"	7
enim	enim	"for; in fact; yes, truly"	6
eo	"eō, īre, iī (or īvī) itūrus"	to go	23
epistula	"epistula, epistulae, f."	letter	13
equidem	equidem	"truly, indeed"	24
equus	"equus, equī, m."	horse	15
eripio	"ēripiō, ēripere, ēripuī, ēreptus"	"to snatch away; rescue, free"	28
erro	"errō, errāre, errāvī, errātus"	to wander; err	4
et	et	and	2
et	et	"even, also"	9
et	et … et	both … and	2
etiam	etiam	"also, even"	11
ex	ex	"out of, from [+ abl.]"	4
exemplum	"exemplum, exemplī, n."	"example, model"	5
exeo	"exeō, exīre, exiī (or -īvī) exitūrus"	"to go out, exit"	23
exercitus2	"exercitus, exercitūs, m."	army	16
exspecto	"exspectō, exspectāre, exspectāvī, exspectātus"	"to wait for, expect; hope for"	26
fabula	"fābula, fābulae, f."	story	3
facies	"faciēs, faciēī, f."	face; appearance	16
facile	facile	easily	4
facilis	"facilis, facile"	easy	10
facio	"faciō, facere, fēcī, factus"	to do; make	8
factum	"factum, factī, n."	"deed, act, exploit, achievement"	4
fama	"fāma, fāmae, f."	"fame, report, reputation; rumor"	6
fas	"fās, n."	right; divine law	31
fatum	"fātum, fātī, n."	"fate, destiny"	17
felix	"fēlīx, fēlīcis"	"fortunate, lucky"	10
femina	"fēmina, fēminae, f."	woman	1
fero	"ferō, ferre, tulī, lātus"	"to carry, bear, endure; report, say"	23
ferox	"ferōx, ferōcis"	"fierce, bold; wild, savage"	32
ferrum	"ferrum, ferrī, n."	iron; sword	17
ferus	"ferus, fera, ferum"	"wild, fierce; cruel; uncivilized"	32
fessus	"fessus, fessa, fessum"	tired	13
festino	"festīnō, festīnāre, festīnāvī, festīnātus"	"to hurry, hasten"	4
fidelis	"fidēlis, fidēle"	"faithful, loyal (to)"	12
fides	"fidēs, fideī, f."	"faith, trust; loyalty, trustworthiness"	16
fido	"fīdō, fīdere, fīsus sum"	"to trust, confide in [+ dat.]"	22
filia	"fīlia, fīliae, f."	daughter	6
filius	"fīlius, fīliī, m."	son	3
finio	"fīniō, fīnīre, fīnīvī, fīnītus"	"to end, finish; limit; die"	9
finis	"finis, finis, f. "	"end, border; (pl.) boundary, territory"	13
fio	"fīō, fierī, factus sum"	"to happen, occur; be done, be made"	28
floreo	"flōreō, flōrēre, flōruī, —"	"to bloom; prosper, flourish"	24
fluctus	"flūctus, flūctūs, m."	wave; commotion	16
flumen	"flūmen, flūminis, n."	river	12
forsitan	forsitan	perhaps	24
forte	forte	by chance	12
fortis	"fortis, forte"	brave; strong	10
fortiter	fortiter	bravely; forcefully	20
fortuna	"fortūna, fortūnae, f."	"chance, luck, fortune"	1
frango	"frangō, frangere, frēgī, frāctus"	"to break, shatter, wreck"	15
frater	"frāter, frātris, m."	brother	7
fructus2	"frūctus, frūctūs, m."	"fruit, enjoyment; profit"	24
fruor	"fruor, fruī, frūctus sum"	to enjoy [+ abl.]	22
fugio	"fugiō, fugere, fūgī, fugitūrus"	"to flee (from), escape, avoid"	9
fungor	"fungor, fungī, fūnctus sum"	"to perform, do [+ abl.]"	22
	"Gallia, Galliae, f."	Gaul	15
gaudeo	"gaudeō, gaudēre, gāvīsus sum"	"to rejoice, be glad; delight in [+ abl.]"	19
gaudium	"gaudium, gaudiī, n."	"joy, delight"	17
gens	"gēns, gentis, f. "	clan	12
genu	"genū, genūs, n."	knee	16
genus	"genus, generis, n."	birth	14
gero	"gerō, gerere, gessī, gestus"	to bear	12
gladius	"gladius, gladiī, m. "	sword	28
gloria	"glōria, glōriae, f."	"glory, fame; ambition, boasting"	24
	"Graecia, Graeciae, f."	Greece	20
graecus	"Graecus, Graeca, Graecum"	Greek	18
gratia	gratiā	"for the sake of, because of [+ gen.]"	10
gratia	"grātia, grātiae, f."	"grace; favor, kindness; gratitude"	10
gravis	"gravis, grave"	"heavy; serious, important; difficult"	21
habeo	"habeō, habēre, habuī, habitus"	to have; consider	1
hic2	hīc	here	31
hic	"hic, haec, hoc"	this	9
hinc	hinc	from this place; hence	31
hodie	hodiē	today	13
homo	"homō, hominis, m."	"human being, man"	7
honestus	"honestus, honesta, honestum"	"honest, worthy, honorable"	31
honor	"honor, honōris, m."	"honor, respect; public office"	14
hora	"hōra, hōrae, f."	"hour, season"	11
hortor	"hortor, hortārī, hortātus sum"	"to urge, encourage"	24
hostis	"hostis, hostis, m. "	"enemy (of the state, usually used in the plural; contrast inimīcus = a personal enemy)"	14
humus	"humus, humī, f."	"ground, earth"	15
iaceo	"iaceō, iacēre, iacuī, iacitūrus"	"to lie (e.g., on the ground), lie dead"	1
iacto	"iactō, iactāre, iactāvī, iactātus"	to throw	5
iam	iam	"now, already"	11
ibi	ibi	there	19
idem	"īdem, eadem, idem"	the same	18
igitur	igitur	therefore	16
ignarus	"ignārus, ignāra, ignārum"	"ignorant (of), unaware (of)"	31
ignis	"ignis, ignis, f."	fire	10
ille	"ille, illa, illud"	that	9
impedimentum	"impedimentum, impedimentī, n."	"hindrance, obstacle"	31
imperator	"imperātor, imperātōris, m."	general; emperor	27
imperium	"imperium, imperiī, n."	"command, (military) power"	3
impero	"imperō, imperāre, imperāvī, imperātus"	"to command, order; rule (over) [+ dat.]"	28
impetus	"impetus, impetūs, m."	attack; charge; impulse	16
impleo	"impleō, implēre, implēvī, implētus"	"to fill, fill up; complete"	3
in	in	"in, on [+ abl.]"	4
in	in	"into, onto [+ acc.]"	4
in	in	against [+ acc.]
incendo	"incendō, incendere, incendī, incēnsus"	"to set fire to, burn; inflame"	15
incipio	"incipiō, incipere, incēpī, inceptus"	to begin	9
incolo	"incolō, incolere, incoluī, —"	"to inhabit, live in"	13
inde	inde	"from there; then, from that time forth"	16
indignus	"indignus, indigna, indignum"	unworthy; undeserved; shameful	15
ineo	"ineō, inīre, iniī (or -īvī) initūrus"	to enter; begin	23
infelix	"īnfēlix, īnfēlīcis"	"unhappy, unlucky"	23
infero	"īnferō, īnferre, intulī, illātus"	"to bring in, introduce; inflict"	23
ingenium	"ingenium, ingeniī, n."	"talent, (innate) nature, character"	25
ingens	"ingēns, ingentis"	"huge, mighty"	10
ingredior	"ingredior, ingredī, ingressus sum"	"to enter; march, walk"	22
inimicus	"inimīcus, inimīca, inimīcum"	"unfriendly, hostile (to)"	12
inquam	inquit	(s)he said [introduces a direct quotation]	19
insidiae	"īnsidiae, īnsidiārum, f. pl."	"ambush, plot; treachery"	31
intellego	"intellegō, intellegere, intellēxī, intellēctus"	to understand	21
inter	inter	"between, among [+ acc.]"	9
interficio	"interficiō, interficere, interfēcī, interfectus"	"to kill, destroy"	17
iniuria	"inūria, inūriae, f."	"injury, harm; insult, wrong"	25
invenio	"inveniō, invenīre, invēnī, inventus"	"to find; discover, invent"	13
ipse	"ipse, ipsa, ipsum"	"___self, himself, herself, itself; very"	18
ira	"īra, īrae, f."	anger	6
iratus	"īrātus, īrāta, īrātum"	angry	8
is	"is, ea, id"	"he, she, it, (pl.) they; this, that"	8
ita	ita	"thus, so, in this way"	13
	"Ītalia, Ītaliae, f."	Italy	6
itaque	itaque	"and so, therefore"	12
iter	"iter, itineris, n."	"journey, path, route; a day’s march"	12
iterum	iterum	"again, a second time"	30
iubeo	"iubeō, iubēre, iūssī, iūssus"	"to order, command"	20
iudex	"iūdex, iūdicis, m."	judge	27
iudicium	"iūdicium, iūdiciī, n."	"court, trial; judgment"	14
iudico	"iūdicō, iūdicāre, iūdicāvi, iūdicātus"	to judge; decide	8
iungo	"iungō, iungere, iūnxī, iūnctus"	"to join, unite, connect; yoke"	25
ius2	"iūs, iūris, n."	"right, law; justice"	7
iustus	"iūstus, iūsta, iūstum"	"just, fair"	21
iuvo	"iuvō, iuvāre, iūvī, iūtus"	to help; please	1
labor2	"labor, labōris, m."	"work, labor, effort; hardship"	15
laboro	"labōrō, labōrāre, labōrāvī, labōrātus"	"to work, strive"	1
lacrima	"lacrima, lacrimae, f."	tear	9
laetus	"laetus, laeta, laetum"	happy; fertile	6
latus	"lātus, lāta, lātum"	"wide, broad"	26
laudo	"laudō, laudāre, laudāvī, laudātus"	to praise	1
laus	"laus, laudis, f."	praise	15
legatus	"lēgātus, lēgātī, m."	"delegate, envoy, ambassador; legion commander"	14
lego2	"legō, legere, lēgī, lēctus"	"to read; choose, select"	8
levis	"levis, leve"	"light, easy; swift"	18
lex	"lex, lēgis, f."	law	7
liber	"līber, lībera, līberum"	free	5
liber4	"liber, librī m."	book	3
liber2	"līberī, līberōrum, m. pl."	children	19
libertas	"lībertās, lībertātis, f."	"freedom, liberty"	7
licet	"licet, licēre, licuit"	"it is allowed, it is lawful [+ dat.]"	31
littera	"littera, litterae, f. pl."	"letter (of the alphabet); pl. letter, literature"	8
litus3	"lītus, lītoris, n."	"shore, beach, coast"	14
locus	"locus, locī, m. (in pl. sometimes n.)"	"place, position"	2
longus	"longus, longa, longum"	long	5
loquor	"loquor, loquī, locūtus sum"	"to speak, talk, say"	22
lumen	"lūmen, lūminis, n."	"light, lamp, torch; eye"	31
luna	"lūna, lūnae, f."	moon	2
lux	"lūx, lūcis, f."	light	7
maestus	"maestus, maesta, maestum"	"sad, mournful"	26
magnus	"magnus, magna, magnum"	"large, great; important"	5
male	male	badly	29
malo	"mālō, mālle, māluī, —"	"to prefer, want (something) more"	20
malus	"malus, mala, malum"	bad	5
maneo	"maneō, manēre, mānsī, mānsūrus"	"to remain, stay"	6
manus	"manus, manūs, f."	hand; band (of men)	16
mare	"mare, maris, n."	sea	10
mater	"māter, mātris, f."	mother	7
medius	"medius, media, medium"	"middle, middle of (medium mare = “the middle of the sea”)"	13
memoria	"memoria, memoriae, f."	"memory, recollection; history"	24
mens	"mēns, mentis, f. "	"mind, judgment, reason"	10
mentior	"mentior, mentīrī, mentītus sum"	"to lie, speak/say falsely"	25
metuo	"metuō, metuere, metuī, metūtus"	"to fear, dread"	27
metus 	"metus, metūs, m."	"fear, dread; anxiety"	16
meus	"meus, mea, meum"	"my, mine"	5
miles	"mīles, mīlitis, m."	soldier	9
mille	mille	thousand	11
mirabilis	"mīrābilis, mīrābile"	"wonderful, extraordinary"	32
miror	"mīror, mīrārī, mīrātus sum"	"to wonder (at), be surprised at; admire"	22
misceo	"misceō, miscēre, miscuī, mixtus"	"to mix, mingle; stir up, disturb"	11
miser	"miser, misera, miserum"	"miserable, unhappy"	6
mitto	"mittō, mittere, mīsī, missus"	to send	8
moenia	"moenia, moenium, n. pl."	"walls, fortifications"	8
moneo	"moneō, monēre, monuī, monitus"	"to advise, warn, remind"	1
mons	"mōns, montis, m. "	mountain	13
monstro	"mōnstrō, mōnstrāre, mōnstrāvī, mōnstrātus"	"to show, demonstrate"	3
mora	"mora, morae, f."	delay	22
morior	"morior, morī, mortuus sum"	to die	25
moror	"moror, morārī, morātus sum"	to delay	22
mors	"mors, mortis, f. "	death	10
mortalis	"mortālis, mortāle"	"mortal, transient; human"	20
mos	mōs est	"it is the custom, habit, way [+ subjunctive]"	28
mos	"mōs, mōris, m."	"custom, tradition"	18
motus2	"mōtus, mōtūs, m."	"emotion, impulse; movement"	24
moveo	"moveō, movēre, mōvī, mōtus"	to move; excite; affect	6
multitudo	"multitūdō, multitūdinis, f."	"multitude, great number, crowd"	20
multus	"multus, multa, multum"	"much, many"	5
murus	"mūrus, mūrī, m."	wall; fortification wall for a city	25
nam	nam	"for (= because); indeed, truly"	13
narro	"nārrō, nārrāre, nārrāvī, nārrātus"	to tell (a story)	3
nascor	"nāscor, nāscī, nātus sum"	to be born	30
natura	"nātūra, nātūrae, f."	nature	2
natus	"nātus, nātī, m."	son	30
nauta	"nauta, nautae, m."	sailor	1
navigo	"nāvigō, nāvigāre, nāvigāvī, nāvigātus"	"to sail, sail over (across), navigate"	4
navis	"nāvis, nāvis, f. "	ship	13
ne	nē	in order that … not [used with subjunctive]	25
ne	nē 	not [used with imperative and perfect subjunctive]	25
ne	nē … quidem	not … even	25
neque	nec	"and not, and … not"	10
neque	nec … nec	neither … nor	10
necesse	necesse	necessary	20
nefas	"nefās, n."	"sin, crime (against divine law), wrong"	26
neglego	"neglegō, neglegere, neglēxī, neglēctus"	"to ignore, neglect"	24
nego	"negō, negāre, negāvī, negātus"	"to deny, say that … not"	19
nemo	"nēmō, m."	no one	3
neque	neque	"and not, and … not"	10
nescio	"nesciō, nescīre, nescīvī, nescītus"	not to know	19
neuter	"neuter, neutra, neutrum"	neither (of two)	11
ni	nī	"unless, if … not"	27
nihil	"nihil, n."	nothing	8
nil	"nīl, n."	nothing	8
nisi	nisi	"unless, if … not"	27
noceo	"noceō, nocēre, nocuī, nocitūrus"	"to harm, be harmful to [+ dat.]"	7
nolo	"nōlō, nōlle, nōluī"	"to be unwilling, not want"	20
nomen	"nōmen, nōminis, n."	name	7
non	nōn	not	4
noster	"noster, nostra, nostrum"	"our, ours"	5
novus	"novus, nova, novum"	new; strange	6
nox	"nox, noctis, f. "	night	11
nubes	"nūbēs, nūbis, f."	cloud	14
nullus	"nūllus, nūlla, nūllum"	"not any, no"	11
num	num	[signals a question that expects the answer “no”]	27
num	num	whether [in indirect question]	27
numen	"nūmen, nūminis, n."	"divine will, divine power"	11
numquam	numquam	never	20
nunc	nunc	"now, at present"	6
nuntio	"nūntiō, nūntiāre, nūntiāvī, nūntiātus"	"to announce, report"	6
nuntius	"nūntius, nūntiī, m."	messenger; message	17
ob	ob	because of [+ acc.]	10
occasio	"occāsiō, occāsiōnis, f."	"occasion, opportunity"	29
oculus	"oculus, oculī, m."	eye	4
odi	"ōdī, ōdisse, —"	to hate; dislike	27
odium	"odium, odiī, n."	"hatred, unpopularity"	27
offero	"offerō, offerre, obtulī, oblātus"	"to offer, bring forward"	23
olim	ōlim	once (upon a time); one day (in the future)	9
omnis	"omnis, omne"	"all, every"	10
oportet	"oportet, oportēre, opportuit"	"it is right, one should; it is necessary [+ acc.]"	31
oppidum	"oppidum, oppidī, n."	town	28
ops	"ops, opis, f."	"power, help; (pl.) wealth, resources"	14
opto	"optō, optāre, optāvī, optātus"	"to choose, desire, wish for"	1
opus	opus est	there is a need (of)/use (for) [+ dat.]	25
opus	"opus, operis, n."	"work, labor, task"	25
orbis	"orbis, orbis, m. "	circle; universe [orbis terrārum “the world”]	18
oro	"ōrō, ōrāre, ōrāvi, ōrātus"	"to pray, beg (for) [often with two accusatives: one of the person, the other of the thing]"	6
ostendo	"ostendō, ostendere, ostendī, ostentus/ostēnsus"	"to show, reveal"	19
par	"pār, paris"	equal (to)	12
pareo	"pāreō, pārēre, pāruī, paritūrus"	"to obey, be obedient to [+ dat.]"	7
paro	"parō, parāre, parāvī, parātus"	to prepare	3
pars	"pars, partis, f. "	"part, share, direction"	10
parvus	"parvus, parva, parvum"	small	5
passus3	"passus, passūs, m."	"pace, footstep [mīlle passūs “mile”]"	16
pateo	"pateō, patēre, patuī, —"	"to be open, stand open"	17
pater	"pater, patris, m."	father; senator	7
patior	"patior, patī, passus sum"	"to suffer, allow"	22
patria	"patria, patriae, f."	"country, fatherland"	9
paucus	"paucī, paucae, pauca"	few	13
paulus	"paulus, paula, paulum"	"little, small"	32
pax	"pāx, pācis, f."	peace	7
pectus 	"pectus, pectoris, n."	"breast, chest; heart"	15
pecunia	"pecūnia, pecūniae, f."	"money, property"	1
per	per	"through, along; because of; by (in oaths and prayers) [+ acc.]"	10
pereo	"pereō, perīre, periī (or -īvī) peritūrus"	"to perish, die"	23
periculum	"perīculum, perīculī, n."	danger	15
peritus	"perītus, perīta, perītum"	"experienced, skillful"	29
persuadeo	"persuādeō, peresuādēre, persuāsī, persuāsus"	to persuade [+ dat.]	17
pes	"pēs, pedis, m."	foot	12
peto	"petō, petere, petīvī or petiī, petītus"	"to seek, go after; ask; attack"	9
philosophia	"philosophia, philosophiae, f."	philosophy	27
placeo	"placeō, placēre, placuī, placitūrus"	"to please, be pleasing to [+ dat.]"	7
plenus	"plēnus, plēna, plēnum"	"full (of), filled (with) [+ gen. or abl.]"	8
plus	"plūs, plūris, n."	more [often + gen.]	21
poena	"poena, poenae, f."	penalty [poenam dō “to pay the penalty”]	26
poeta	"poēta, poētae, m."	poet	9
pono	"pōnō, pōnere, posuī, positus"	"to put, place"	13
pons	"pons, pontis, m. "	bridge	25
pontus	"pontus, pontī, m."	"sea, ocean"	3
populus	"populus, populī, m."	"the people, a people, nation"	6
porto	"portō, portāre, portāvī, portātus"	"to carry, bring"	3
possum	"possum, posse, potuī, —"	"to be able, can"	7
post	post [+ acc.]	"after, behind"	4
postea	posteā	afterwards	26
postquam	postquam	"after, when"	12
postulo	"postulō, postulāre, postulāvī, postulātus"	"to demand, claim; prosecute"	20
potens	"potēns, potentis"	powerful; able	10
potior	"potior, potīrī, potītus sum"	"to get hold of, acquire [+ abl.]"	22
potus2	"pōtus, pōtūs, m."	drink	22
praebeo	"praebeō, praebēre, praebuī, praebitus"	"to show; offer, provide"	9
primo	prīmō	at first	32
primum	prīmum	"first, in the first place, for the first time"	30
primus	"prīmus, prīma, prīmum"	first	5
princeps	"prīnceps, prīncipis, m."	"leader, chief; first citizen, emperor"	17
prius	prius	"before, sooner"	30
pro	prō	in front of; on behalf of; instead of [+ abl.]	4
probo	"probō, probāre, probāvī, probātus"	"to approve (of); prove, show"	29
proelium	"proelium, proeliī, n."	battle	15
proficiscor	"proficīscor, proficīscī, profectus sum"	"to set out, depart"	22
prohibeo	"prohibeō, prohibēre, prohibuī, prohibitus"	"to prohibit, keep from; keep someone (acc.) from something (abl.)"	15
propinquus	"propinquus, propinqua, propinquum"	"near (to), neighboring; near, not far off [of time]"	22
propinquus	"propinquus, propinquī, m."	"relative, kinsman"	22
propter	propter	"because of, on account of [+ acc.]"	6
provincia	"prōvincia, prōvinciae, f."	province	15
puella	"puella, puellae, f."	girl	2
puer	"puer, puerī, m."	boy	2
pugno	"pugnō, pugnāre, pugnāvī, pugnātus"	to fight	3
pulcher	"pulcher, pulchra, pulchrum"	"beautiful, handsome; fine"	5
puto	"putō, putāre, putāvī, putātus"	"to think, consider; suppose"	19
quaero	"quaerō, quaerere, quaesīvī ( or -iī), quaesītus"	"to look for, seek; ask"	21
quam	quam	"(rather) than, as [in comparison]"	21
quam	quam	"how, how much; as ___ as possible [with superlatives]"	22
quamquam	quamquam	although	17
quantus	"quantus, quanta, quantum"	how much	25
qui	"quī, quae, quod"	"who, which, that"	13
qui	"quī, quae, quod"	which ___? what ___?	18
quia	quia	because	12
quidam	"quīdam, quaedam, quoddam"	"a certain ___, a sort of ___"	21
quidem	quidem	"indeed, certainly in fact"	25
quisquis	"quiquis, quicquid (quidquid)"	"whoever, whatever; everyone who"	26
quis	"quis, quid"	"who, what"	18
quis2	"quis, quid (= aliquis, aliquid)"	"someone, something, anyone, anything [with sī, nisi, num, nē]"	26
quod	quod	"because, since"	12
quomodo	quōmodo	how 	28
quoniam	quoniam	"since, seeing that"	21
quoque	quoque	also	26
quot	quot	how many?	28
quotiens	quotiēns	how often?	28
rapio	"rapiō, rapere, rapuī, raptus"	"to seize, snatch, carry off"	14
ratio	"ratiō, ratiōnis, f."	"reason, judgment; method"	11
recipio	"recipiō, recipere, recēpī, receptus"	"to receive, accept; take back, regain"	32
rectus	"rēctus, rēcta, rēctum"	"straight, upright; right; virtuous, honest"	24
redeo	"redeō, redīre, rediī (or -īvī) reditūrus"	"to go back, return"	23
refero	"referō, referre, rettulī, relātus"	"to carry back, bring back, report"	23
regina	"rēgina, rēginae, f."	queen	6
regnum 	"rēgnum, rēgnī, n."	"kingdom, royal power"	2
rego	"regō, regere, rēxī, rēctus"	to rule	8
relinquo	"relinquō, relinqere, relīquī, relictus"	"to leave, abandon"	9
reliquus	"reliquus, reliqua, reliquum"	"remaining, rest (of)"	13
requiro	"requīrō, requīrere, requīsīvī (or -iī), requīsītus"	"to search for; ask, inquire after; demand"	28
res	"rēs pūblica, reī pūblicae, f."	"state, republic"	16
res	"rēs, reī, f."	"thing, matter, business; court case"	16
resisto	"resistō, resistere, restitī, —"	"to resist, oppose, make a stand [often + dat.]"	21
respondeo	"respondeō, respondēre, respondī, respōnsus"	"to answer, reply; correspond to"	19
rex	"rēx, rēgis, m."	king	7
rideo	"rīdeō, rīdēre, rīsī, rīsus"	"to laugh, laugh at"	2
rogo	"rogō, rogāre, rogāvī, rogātus"	"to ask, ask for"	28
roma	"Rōma, Rōmae, f."	Rome	13
romanus	"Rōmānī, Rōmānōrum, m. pl."	the Romans	6
romanus	"Rōmānus, Rōmānī, Rōmānum"	Roman	6
romulus	"Rōmulus, Rōmulī, m."	Romulus (legendary founder of Rome)	3
rosa	"rosa, rosae, f."	rose	1
rus	"rūs, rūris, n."	the country(side)	15
sacer	"sacer, sacra, sacrum"	sacred	20
saepe	saepe	often	4
sapiens	"sapiēns, sapientis"	"wise, sensible"	20
sapientia	"sapientia, sapientiae, f."	wisdom	5
saxum	"saxum, saxī, n."	"rock, stone; cliff"	4
scelus	"scelus, sceleris, n."	"crime, wicked deed, wickedness"	18
scio	"sciō, scīre, scīvī, scītus"	to know; know how to [+ inf.]	19
scribo	"scrībō, scrībere, scrīpsī, scrīptus"	to write	8
confero	sē cōnferō	"to proceed, go"	23
secundus	"secundus, secunda, secundum"	second; favorable	11
sed	sed	but	2
sedeo	"sedeō, sedēre, sēdī, sessūrus"	to sit	4
semper	semper	always	4
senatus	"senātus, senātūs, m."	senate	16
senex	"senex, senis, m."	old man	18
sensus2	"sēnsus, sēnsūs, m."	"sense, perception; emotion; idea"	27
sentio	"sentiō, sentīre, sēnsī, sēnsus"	"to feel, perceive"	8
sequor	"sequor, sequī, secūtus sum"	"to follow, accompany; pursure"	22
servio	"serviō, servīre, servīvī or serviī, servītūrus"	to serve [+ dat.]	9
servus2	"servus, servī, m."	"slave, servant"	17
si	sī	if	12
sic	sīc	"thus, so"	11
signum	"signum, signī, n."	"sign, token, signal; (military) standard"	17
silva	"silva, silvae, f."	"forest, wood"	3
similis	"similis, simile"	"similar (to), like"	12
sin	sīn	"but if, if however"	27
sine	sine	without [+ abl.]	6
sino	"sinō, sinere, sīvī, sītus"	"to allow, permit"	20
socius2	"socius, sociī, m."	"companion, comrade, ally"	27
sol	"sōl, sōlis, m."	sun	26
soleo	"soleō, solēre, solitus sum"	to be accustomed	2
solus	"sōlus, sōla, sōlum"	"alone, only"	11
specto	"spectō, spectāre, spectāvī, spectātus"	"to watch, look at"	13
spero	"spērō, spērāre, spērāvī, spērātus"	"to hope, hope for"	19
spes	"spēs, speī, f."	hope	16
statim	statim	"immediately, at once"	28
sto	"stō, stāre, stetī, statūrus"	to stand	14
studium	"studium, studiī, n."	"eagerness, zeal; study"	29
sub	sub	"under, beneath [+ abl.]"	5
sub	sub	"to the foot/base of, along under [implying motion] [+ acc.]"	5
subeo	"subeō, subīre, subiī (or -īvī) subitūrus"	to go up; to undergo; to approach	23
subito	subitō	suddenly	11
sum	"sum, esse, fuī, futūrus"	"to be, exist"	5
super2	super	"over, above, on (top of) [+ acc.]"	15
superus	"superī, superōrum, m. pl."	gods	20
supero	"superō, superāre, superāvī, superātus"	"to overcome, conquer, surpass"	1
superus	"superus, supera, superum"	"upper, higher, above"	20
surgo	"surgō, surgere, surrēxī, surrēctus"	"to get up, (a)rise"	14
suus	"suus, sua, suum"	"his, her, its, their own"	15
taceo	"taceō, tacēre, tacuī, tacitūrus"	to be silent	1
talis	"tālis, tāle"	"such, of such a kind"	20
tam	tam	"so, to such a degree"	16
tamen	tamen	"however, nevertheless, yet"	9
tamquam	tamquam	"as, just as, just like"	29
tandem	tandem	finally	4
tantum2	tantum	only	14
tantus	"tantus, tanta, tantum"	"so much, so great"	14
tellus	"tellūs, tellūris, f."	"the earth; land, ground"	31
telum	"tēlum, tēlī, n."	weapon; spear	28
tempestas	"tempestās, tempestātis, f."	storm; weather	28
templum	"templum, templī, n."	"temple, shrine"	3
tempto	"temptō, temptāre, temptāvī, temptātus"	"to try, attempt; test, prove"	17
tempus	"tempus, temporis, n."	"time, period of time; opportunity"	11
teneo	"teneo, tenēre, tenuī, tentus"	"to hold, posses, keep; restrain"	6
terra	"terra, terrae, f."	"land, earth, soil; country"	5
terreo	"terreō, terrēre, terruī, territus"	"to terrify, scare"	1
timeo	"timeō, timēre, timuī, —"	"to fear, be afraid (of)"	1
timor	"timor, timōris, m."	"fear, terror"	9
tollo	"tollō, tollere, sustulī, sublātus"	"to lift up, raise; remove, carry off, steal"	23
tot	tot	"so many, as many"	18
totiens	totiēns	so often	25
totus	"tōtus, tōta, tōtum"	"whole, entire"	11
trado	"trādō, trādere, trādidī, trāditus"	"to hand over, surrender; hand down, report"	19
traho	"trahō, trahere, trāxī, tractus"	"to drag, pull; derive"	14
trans	trāns	"across, beyond [+ acc.]"	4
transeo	"trānseō, trānsīre, trānsiī (or -īvī) trānsitūrus"	"to go across, cross"	23
tremo	"tremō, tremere, tremuī, —"	"to tremble, shake"	26
tres	"trēs, tria"	three	11
tristis	"tristis, triste"	sad; gloomy	20
troia	"Trōia, Trōiae, f."	Troy	14
troianus	"Trōiānus, Trōiāna, Trōiānum"	Trojan	30
tu	"tū, tuī, tibi, tē, tē"	you (sg.)	7
tu	"vōs, vestrum (vestrī), vōbīs, vōs, vōbīs"	you (pl.)	7
tum	tum	"then, at that time; next"	4
tunc	tunc	then	6
turba	"turba, turbae, f."	crowd	3
turpis	"turpis, turpe"	"shameful, base; ugly, foul"	21
tuus	"tuus, tua, tuum"	"your, yours, your own (sg.)"	5
ubi	ubi	when	12
ubi	ubi	where	12
ullus	"ūllus, ūlla, ūllum"	any	11
unda	"unda, undae, f."	"wave, waters; sea"	14
unde	unde	"from where, whence"	26
undique	undique	on all sides	28
unus	"ūnus, ūna, ūnum"	one	11
urbs	"urbs, urbis, f. "	city	10
ut	ut	"in order that, so that"	25
ut	ut	as	32
uter3	"uter, utra, utrum"	which? (of two)	11
uterque	"uterque, utraque, utrumque"	"both, each (of two)"	14
utilis	"ūtilis, ūtile"	"useful, profitable"	29
utinam	utinam	"[signals a wish] if only, would that"	24
utor	"ūtor, ūtī, ūsus sum"	to use [+ abl.]	22
uxor	"uxor, uxōris, f."	wife	13
valeo	valē; valēte	"goodbye, farewell"	8
valeo	"valeō, valēre, valuī, valitūrus"	"to be well, healthy; to be strong"	8
venio	"veniō, venīre, vēnī, ventūrus"	to come	8
ventus	"ventus, ventī, m."	"wind, breeze"	3
verbum	"verbum, verbī, n."	word	4
vereor	"vereor, verērī, veritus sum"	"to fear, be afraid; respect"	27
veritas	"vēritās, vēritātis, f."	truth	8
vero	vērō	"in fact, truly, indeed"	14
verto	"vertō, vertere, vertī, versus"	"to turn, turn around; destroy, change"	13
verum2	"vērum, vērī, n."	"truth, what is true"	29
verus	"vērus, vēra, vērum"	true 	29
vescor	"vescor, vescī, —"	"to eat, feed on [+ abl.]"	22
vester	"vester, vestra, vestrum"	"your, yours (pl.)"	5
veto	"vetō, vetāre, vetuī, vetitus"	to forbid; order … not	20
via	"via, viae, f."	road; way	4
victoria	"victōria, victōriae, f."	victory	27
video	"videō, vidēre, vīdī, vīsus"	to see	1
video	"videor, vidērī, vīsus sum"	to seem; be seen; seem best to	14
vinco	"vincō, vincere, vīcī, victus"	to conquer; win	13
vinum	"vīnum, vīnī, n."	wine	17
vir	"vir, virī, m."	man; husband	2
vis	"vīrēs, vīrium, f. pl."	strength	23
virtus	"virtūs, virtūtis, f."	"courage, excellence, virtue"	7
vis	"vīs, vīs, f."	"power, force, violence"	23
vita	"vīta, vītae, f."	life	6
vito	"vītō, vītāre, vītāvī, vītātus"	to avoid	15
vivo	"vīvō, vīvere, vīxī, —"	"to live, be alive"	14
voco	"vocō, vocāre, vocāvī, vocātus"	"to call, summon"	1
volo	"volō, velle, voluī, —"	"to wish, want, be willing"	20
voluptas	"voluptās, voluptātis, f."	"pleasure, delight"	29
volvo	"volvō, volvere, volvī, volūtus"	"to roll, turn/twist around"	14
vox	"vōx, vōcis, f."	voice	18
vulnero	"vulnerō, vulnerāre, vulnerāvī, vulnerātus"	to wound	17
vulnus	"vulnus, vulneris, n."	wound	17
vultus	"vultus, vultūs, m."	expression; face	16
